X_nematophila_RAND_1	TATTGTACCGGAAAAAACCTTAACTCGTGATAGCAACGGGCAGTTATCCGTCACCTGGCGCCCGGATTTAAAAGGTCAGGTG
X_nematophila_RAND_2	GGCGATGAAAACGTTCTTTAATGCGTGAAGCCAGAATGCCGACGACCCCCTGATGCCATTCAGGATGGTAAATCGCCAGGCCGTAAGGTAACTGAGTGTGCGTCCGCTCGATTTGATCGCAAATTTGCAGGGCTTCTTGCTGCATTCCCAGCTC
X_nematophila_RAND_3	CAACTCTTTGTTTAATAAAAATTTATCGCAGTATAAAATATTGCCAGTTTTATAGACTATATTA
X_nematophila_RAND_4	AGGTTATGCTTAAGGGCACATCGACATAATCGTCATCTTGTCCTATAGGGCTAGGAAGCGGAATTTTCTCATTATCTTCGAAGTAAAATTCGAAAGACGTTATTAG
X_nematophila_RAND_5	TATGACCGGTGACGATATGAAATCCCGATGCGTAATCCCGATGAGTCACAGGAATGCCTGCATAGGCTAATCCACCAATCGGGGAACTAATACCCGGAATAATTT
X_nematophila_RAND_6	GCGATGCCTTGAATGCTCTATCTGAGAAATATTTTTGAGCTGGTCGACGACCGTTTCTATCAAAAATCTCCGTCTTAACATCAACCTATCCCAGAGAGATAATGCTTTGGTTTTCATGTTATTCCGGACATTGGTGATTAACG
X_nematophila_RAND_7	TCCGCTTGCTCTTCCTGACAAGCATAATGTTCAAGAATTTTCCTCACCTGCAATAAATGCTCGGGCA
X_nematophila_RAND_8	CCGATAACGATTACCGTGTGCGGATTCCCCAGGCCTTTGAAGGC
X_nematophila_RAND_9	GTTACGCTCTAGAATTAACTCAAAGCTACCGCACTAGGTTACGGCTCCCAGAGTGCCTGCCATGTATGAAAATTTGGCTTATCCTCTTAGT
X_nematophila_RAND_10	ATTATCAGACATCCGTGAGGAAGACAAAACAATAGGTCGATTTATAAGAGATAGATATCCTGCTGTTATTGGTGA
X_nematophila_RAND_11	TTACAATGATACTGATAAGATAGCGCTACCTAATGCTGATAATTATGACTTAACTATCCATCATACAGATAGAGTTATAAAAGACATATATGATGTGATTGATAAAA
X_nematophila_RAND_12	GAGCAATATTTTGTGCCATTTATGTACAAATCAAATAACCATCATTTTGACTGTCAATTCATAGAATCATTTAGAAATAAAGATGGCTATT
X_nematophila_RAND_13	TTAGGCAATGCATTTTGTGCTTGCTCCATTATTTCCACCAAACCGACGTTAAAAGAGAGTCGTCTCTTGTTACATTTTTAATATTGAAAAGGTTGATAGGTGCTAGCCAAGAAAATGGTGAATAAAGATTATGGTTTATTGGTTTTTGACCGTGTAGTTTCTTACTCGTTTCACTGGCTTTAGTCTTAACCTGTCACTAAACCTCGGTTTAGTGGGAACCGAATTACCGGTCGGTGTACCTATTCCGTGGCCGTTAGCGATCCCTCCGGCTGGATGGCTGAAATGTAACGGATCAACGTTTACTACGGAGCAATACCCTCAGTTGGCAC
X_nematophila_RAND_14	CACCGTGGCGAAACGGTCTACAACATTGAAACAAGTGCCGCACAGGTGATTGCAGTGCTCGGTGATTATCCTCCAAACACAACTCCAGAGGCCCCAAC
X_nematophila_RAND_15	AATAAGGGGCTAACTGATGGCATTACCTCGCAAACTTAAATACCTGAACTTGTTCAATGATGGCAACAACTATCAGGGGATCGTGGAAGAGCTGACTCTTCCTAAGTTGAGCCGCA
X_nematophila_RAND_16	CTTCACCTTTCTTAAAATCACTCTCTTCAAATAACATTATCTCCAATNNTCCCCAAACTTTTTAGGGTCTCTATATTGAGATCTAAGA
X_nematophila_RAND_17	ATTATATCAGGCGGTGACAAAGATTTTATCCTCACCGATATGGCGGCAGCAGGCACAAATTAT
X_nematophila_RAND_18	GTCTATCAGACAAGGAACCAGCCCGCTAGGCGAGAATGCTCTGAATTTCTCA
X_nematophila_RAND_19	TACTTATGTCACTTTTATATCAGGTCAAGGTGATAGATTTGAGTGGTTTTTTGTTGATTAAATGGTGTTATTATCTAATGTTTTTTGTA
X_nematophila_RAND_20	GGCGCGTGAACTGGGAATTCGCCATGTCGATACAGTCTGTATTTCCAGCTATGACCATGATAACCAGCGCGAAC
X_nematophila_RAND_21	CCCAAAATGGCAGCCAACGCAGAAAGATTATCATTATCGCCCACTTTAATTTCTGCTGTAGCAACAGCATCATTTTCGTTAATGATGGGAACTATGTGATTATCAAGCAGT
X_nematophila_RAND_22	TCACCATGAGGTGTTTTCATGGTCTTAGCGACTCTAACAGCAGGTGCAGCCATACGAGTATGGTCAACTTTAAAACTATCCAATAAAG
X_nematophila_RAND_23	TTGCTGACCAACTGAATAAATCGCCCAAATACTGCGGATTATTGGGATCAAGCGCTTCATTTGCCAATGGCAATCCCATTTCTACCAAATTCAATAACAGGCGACGGGCA
X_nematophila_RAND_24	ATTTGGTAGAAATGGGATTGCCATTGGCAAATGAAGCGCTTGATCCCAATAATCCGCAGTATTTGGGCGATTTATT
X_nematophila_RAND_25	GGTGGGGTTCAAACGTATGAAACGGTCAATGGATGCGATAG
X_nematophila_RAND_26	TCCATTTCAATGCCAGTAATCGGATGGTAAAGACGCAACATAGTCGCATGCAATGCCTGGCGATCAAAGTTGCGCATCACTTCGCGAAATTCGTCTGATGCTCCTTTTAAAGGACGAG
X_nematophila_RAND_27	TGAATTGCACTGCGTTGGTGCGACGACATTGGATGAATATCGTCAATACATTGAA
X_nematophila_RAND_28	GCATGATATCGCTTATGATATCGCTGGTGCTATAACTGGTTATAGTTTGTACCAAACTATAAAGTAAATAATGCCCAAAATGCAAAAAAGCCATCCGGCG
X_nematophila_RAND_29	AATACTTTCTTTATTGAGTGCGACAATGCTGGCGGCTTGTGCAACCGCAATGGCTGGCCCGATTGCGTTTATTGGTCTGGCTGCACCCCACTTGATGCGGGCGTTGGTG
X_nematophila_RAND_30	CTGCACAATCTGCCATGTTATTTTTTATCAGATAAGTATGCTGCACAATCTGCCATGTTATTTTTTATTTGTAGGCGTAACCATTTGCATTTATGTTGGGGGAGTATCAGGATATTAACAG
X_nematophila_RAND_31	GTCAGCCATTTCAGTACTCAGAAAGCGGCTGCAATACTGGGATTAGGGTATAACTCAGTTATCTCGGTTCCTTGTGACAGTGAATTCTGTATGTCATCTCAG
X_nematophila_RAND_32	AAAAATCGCTGGTGATTTTGACAGGTTGCCCGATGCGCATGTTTGTAAGCTGAGTTTCTTTGAAGTTAGCTTCAATCCACATGTTCGTCGCAGGTATGATAGCCATCAATGGTGTTCCTGAA
X_nematophila_RAND_33	AGTGTACAAAAACATCTTTGCTACCATCTTCTGGAGTAATAAAACCAAATCCTTTGGATTCATTAAACCACTTAACGTTACCTTTAATTTTTGACATCAAACTTACCTTTATAAAAAAAGACACAAACATAGCGTCACCTACAGTACAACAA
X_nematophila_RAND_34	ACTATGCTGACCCTTGGTCAATATTTGCAACCAAGCCGCCATC
X_nematophila_RAND_35	ATCCGCGAGATGCCCGATGAAGAACGTCAGGTTCTGGCGGCAATGGTTGTGCGCAGACGTCAGTTAACCACCATGTTGGTTGCTGAGCGTCATCGCCTGTATCCGTCTCATCCTCAGAACCGCAAAAGTATTAACGTGATTATTGAAGCATTGGAAAAAGAGTTGTCGCGTATTGATAAGGATATGAATAACCATATCAAAACATATTTTAAAACCCTCTCTGAAAAACTCTGTAGCGTCAAGGGAATTGAGCACGACAACTGCCGCAGTGTTGTTGGCA
X_nematophila_RAND_36	ATTGGAAATTGTGCCCCAAAAAGTGGCTGATCTTGATAAAATATTAGAA
X_nematophila_RAND_37	GAAGAACAGCAATCCATACCATACTGACGCTGCATCTGGTGCGTCAGAAACTGGTGAAATTCAGAACCGCACAGATAAATGCGCTGCACGGTATGTTACTTGAATTTGGCGAAAACCTTCATAAGGGC
X_nematophila_RAND_38	AATAGAAGCCAAAGTACAACACCAATTACGTCAGGGCTT
X_nematophila_RAND_39	CCAGCACGCATTTTTTCAAACAGTGCAAAGTTCTCTTCCACACTACGATCACGATATGGACTGTTTTTACCCGGTTCTTTCAGTGTCCCACGATATTCACGGATCTCTTCAGCACTCAGTTCATCAACATACGCCAATCCTTTGTTGATTAACTCAATGGCGTATTGATACAGGGTATCGAAATAGTCAGAAGAATAGCAAATATTGCCGC
X_nematophila_RAND_40	GGAGTACGCCAACCTTTATTATCCGGACTTACATCGTTTGTTGGTGTTGGAGGTAAATTCTTTATTGCTATAAAA
X_nematophila_RAND_41	ATTTGTTCAAAACACAGGAGAAACCAATGGTACACAATTTGAATCAGGCA
X_nematophila_RAND_42	CACAATTTGAATCAGGCATTAGGTGAACAAATTTATCGTCGCACTGAAACTTCTGACTCAGGACCGGCAGTTTCTCAAGCCTCTGC
X_nematophila_RAND_43	GATTTAAGCTCTTGAATTAATTTATTAAGTTCAGACCATTCTAGGTAGATTTCATTTGCCGTCATAATTCTAGGATGATTT
X_nematophila_RAND_44	TTTTGTTTATCCACGCAATGATCTTTCTTATGCAGCCAATTTCCTGTACATGATGTTCTCCACTCCTTGTGAAGAATATAAGGTCAACCCTGTACTGGAACGCGCCATGGATCGCATTTTCATTCTGCATGCAGACCATGAGCAGAATGCTTCGACTTCAACAGTACGTACTGCGGGTTCCTCGGGTGCCAACCCGTTTGCCTGTATCGCCGCTGGAATTGCATCCCTGTGGGGACCAGCGCATGGCGGAGCAAACGAAGCTTGTCTGCGTATGCTGGAAGAGATCCAATCCATTGAACACATTCCTGAATTTATCGCCCGCGCCAAAGATAAAAACGACTCTTTCCGCCTAATGGGATTCGGTCACCGTGTTTATAAAAACTACGATCCTCGCGCAACAGTCATGCGCGACACCTGCCATGAAGTGCTCAATGAACTCGGTCTGAATGACAGCCTGCTGGAAGTGGCAATGGAGCTGGAGCGTATTGCCCTGAACGACCCGTACTTCATCGAGAAAAAACTGTACCCGAATGTTGATTTCTACTCTGGTATCATATTGAAAGCTATGGGTATTCCATCATCCATGTTCAC
X_nematophila_RAND_45	TGAGATGCGCATAGCACGGGAAGCCCCTGTAATAACTGCCTCCGGAGCATGGCTATTTGCTTGATGCAAACGTGCAAATTCTTTAAAACCAGAATGGAAAATTTGTTCAGCGCCAC
X_nematophila_RAND_46	GTGCCTGTCTCAATATGACTGATCTGGCTGGGCAAAATATT
X_nematophila_RAND_47	TTGGCGGAATGGCTGGGATATTCCCGTGCCTTATTGTTTATTTCTGGTTATGCCGCTAATCAGGGTGTCATTGCTGCTTTGATGGAGAAAGATGATCGCATTATT
X_nematophila_RAND_48	GCGGCGGGATTAAACCAATAGCGGATTTCTGTATCAATTAATGGCGTAGTAGAAACCCCATGATTTAGCCCCCGCTGT
X_nematophila_RAND_49	TGCTACCAACGCACGAATTTGCCCGGATTTAAAATCAGCCAGTGCGCGCGTTCTTGCACCCTGGCTTTTATTGCCGTGGATTGCCGCCGCCGTCACACCATCTTTATTGAGTAGTTCCGCCAGTTTATTTGCACC
X_nematophila_RAND_50	CGTGAGGCACTTTTTGTATTGCCTCTTGAATAATACGGCCAATTTCTTCCCGGCTCATAGCAGGATGCAGCGTATTTTTTTCTAAAGGTTGTTGACTTAATGGTGCCATCGGCAG
X_nematophila_RAND_51	GTTCGCGCATCCTCAGCTTAATGTCACTGATTTGCTCGCGCTGGCGCTGGTATTGCTGTTTGAGGCTGTTCGTCTCGCCACTGTCAGGGATCAGCACTAAACAGCCGTCCATGATTTTTACGGTAACAGAGCCGC
X_nematophila_RAND_52	GCGGCTGACGCCTGATGGTGACCTGCATGTCACCCTGCCGGGGCACCGGTCGTTTATTCTGCTGCGGATGCACAACGGTATGCTGTTGGCGGGTGCCGATGCGTACAGACCCGTTAATTATTGGCCAGGACGGCCAAAACCCCTGCACCTGACCTGCCGGCTGGAT
X_nematophila_RAND_53	GTTTTTTATTTTTACTTCATATAGTTACAAAGAAACACCTT
X_nematophila_RAND_54	AACAAGGCTATCATTCTCGTAGATACACGTTGTCGAGTGCAGCAATCCTACCGGACCAAATGCTGCAATCGTTGATACGTAATGCACGGTTTTGGCTTTGCCGTGTGTGGCTAAACGAAGAATGTTCAGTGTGCTGTCGATGTTGGAGGCGCGTTGTGTTCTGTAAGGGTGAACGTAGTTAACATCTGCGGCTGAATGAAA
X_nematophila_RAND_55	AGCAATTGAACGTCATTGCATAAGGTATCGCTATGAAAGCATTGTCGAAACTAAAGC
X_nematophila_RAND_56	TTCTCCCATCAACGTTCCCCCTTTTGATAACTCAGCAAT
X_nematophila_RAND_57	TTCGGATAAGGCAACAAGTAAAAGCCACGAAGATCTTGTGTTACCCTAGCGACAACGCTTCTGATCAGGTAACATCAAAATCCCTTTTCATTTTATGG
X_nematophila_RAND_58	TTGAAGCTCCCGGTATCAAACCAGGAGCTGTTCATTTTACTTCCGTCCAATGTGAACAGGACTTTTTAAATCAAACTGCGCGGAAGGAAATTTCCGTCGGGATCGTTTCGCCTTTCCAATACATCTGAGCCGCA
X_nematophila_RAND_59	ATACATTGCCGTTTAATTTTTCAATGTCCGTCACACCATGATTGTTTACCGCTTTCAAAGCAAAATTATCAATATCCATGCCCTGATAAATAAATTTATCTGCTGAAAACGAGAGATTTGCATTAAATCCTTGCAA
X_nematophila_RAND_60	AAATTCTGTTTCTCAGATGAATGATCTTGGTCAATCCCAAATAACCGAACCTACATTTAAGTCATCAGAACCATTGATTCAGCCAGATGTTCAGGAGAAAAAAATAGTTTCAATTCCTGCTTCCCATGAATCAAAAACTCCGTATGCTTTTGCGCAGCAACCGCAGCAACCGCAGCAACCGC
X_nematophila_RAND_61	AATACTTGGAGCCTTTATTAGCTTATAGCTTGTCAGTATTTGGAGAAATCCTTTCA
X_nematophila_RAND_62	TTGTTTTTAAATTAATAAACAGATAAAAAATTAATTTCACTGTTTTATTTAATATTACACGTCATTTGTTATTAATAATTTTTTTATTCATCATCACTTTATAGTATTTTACCTTAA
X_nematophila_RAND_63	GCAAAAAGCCAAGCGCGAATTTTGGATTAAATAAGTAAACTGTTACAGCAAAGTTTATGAGTTGCAAAAGTAAAATTCAGGTTAAATAACATTTATTTTGAGATAACAAATAAATGACAATT
X_nematophila_RAND_64	CTTTCAGATCAGCAATGTTTTTAATAGCCGGTACCGCATTCAGCAGTGCATCAACACCCACTTTACCCGCGGTATAGCTGGATTGAGTAGCAGATTCACCACCACCGGCAATAGTTCCCCCTGTCGCCAGAACAGTAATATTTGGCAAAGCAAATGCTGAACCACT
X_nematophila_RAND_65	TTTTTATTATACATACAGCAGCCGATTGTAACAATTTGCTTCTAATTAGTTGAATT
X_nematophila_RAND_66	TGCCGTTCACAGAGAATATTACCCGCCGTTATTGACTTAGATTATTCGCCTTTAGCTGCTTTGAAAGCTTCAGCCATTGCGTTGTTAGCGAAGTTTGTGTCTTCTTGTTTGTTTACAGAAGCGATAGCGTCTTTTTCATCAGCTTCGTCTTTTGCGCGAACAGACAGGTTGATTACGCGGTTTTTGCGATCAACACCAACATATTTAGCTTCAACTTCATCGCCAACGTTCAGAACTTGAGTTGCATCTTCAACGCGGTCACGAGAAGCTTCTGATGCACGCAGGTAACCTTCAACGCCGTCAGCTAATTCAACTGTAGCACCTTTTGCATCAACCGCAGTGACTTTACCATTAACAATTGCACCTTTCTTGTTTACAGACAGGTAGTTGTTGAATGGGTCTTCTGCTAATTGCTTGATGCCCAGAGAGATACGCTCAC
X_nematophila_RAND_67	TGGATAGCACGTTCAGATTCTGTATCCAATGCGGAAGTTGCTTCATCCAGAATCAAAATCGGTGAATCACGCAATAAAGC
X_nematophila_RAND_68	ATGGAAAGAGCTGTTCGCTTTTTTGAACAACGTGGTTTACGCCCTATCGCAGCACCCGCTAATCAATTAGCTATAACAACGCCCTTGTATCCCTGG
X_nematophila_RAND_69	TTTTGGAGAAAGTCTTTCTTCAAAAAGGGATACCTGTGTTAGTGATATCCAATTTACATAAAACAGACCGTATTGTCGCAAAATCTAAAATATTG
X_nematophila_RAND_70	GAAAGATATTCGGTACTAAAGTAAAACTTAGATTACCGCAACGATAGCTTCACACAGAGGAACCATGT
X_nematophila_RAND_71	ATTTGCAGGTAAATGGCTTAACGGGTCGTCAGCACCG
X_nematophila_RAND_72	AATAAAATGCGCGCCAACTCGATTTTCAAGCGGCGCGTCATTTTGACGTTCTGACATAAAAGCATGATGGCAACCATGCAAAATGCCGGTACAAGCTGCACAAAGATCAGGAAGAATACTGCCATGCTGGAATAGTCTTCACTGAACATCACC
X_nematophila_RAND_73	AAGTGATTTGATGCGTTGATATAGCTCACATCTCCTGTCTGATACACAATCCC
X_nematophila_RAND_74	TGATGCAACTACTGTTGGCGCTCGCCCAGATAACGGTATGCTGAGTGTTGGCGTTTCTTACCGTTTTGGTCAGGATGAAGCCGCTCCAGTTGTTGTTGCACCTGTTGTCGCGCCTGTTCCAGTCATTCCAGCACCTACTGTTGAAAACAAGAGCTTCACTCTGCGTTCTGACGTTCTGTTTAATTTCAACAAATCAACACTGAAACCAGAAGGCCAACAAGAGCTGGATAACCTCTACAATCAACTGGCTAAAATCGACCCAACTCAAGGTAATGTTGTGGTAATCGGCTACACTGACCGTATCGGCAGCCAGAATTTTAACCTGCCACTGTCTCACAAACGTGCTCAATCCGTTGTAGATTATCTGGTTGCTAAAGGCATCCCAGCAAACAGCATCCAAGCAGAAGGCCGCGGTAAAGAAAGTCCTGTCACTGGCTCT
X_nematophila_RAND_75	GTGTGGTATTTGGCATGCCGCGTGCTGCAATCCAGTTGGGGGCGGTGGATGATGTCATGGACATCCAAAAAATCAGCAAAGCGATGCTTGCCAAACTCAGCGTAGGGCAATCGATTCGTATTTAGTCGTTATTATTTGATGTTAATTTTTGCAGCACTATTTTTGCAACGTGTGCT
X_nematophila_RAND_76	TCAGCGGCGAAATAGCATCA
X_nematophila_RAND_77	ATTTGTTTAATTGAATAAAAAGGATACTGTAAATATTTTGTCATGTTATCGAAACTAATTTTAATTCATAACAAATAAGTAATTATTTTATTTGATAATTTCTAT
X_nematophila_RAND_78	AGTTCAGTCGGTAGAACGGCGGACTGTTAATCCGTATGTCGCTGGTTCAAGTCCAGCTGGAGGAGCCAAATTCTGGAAAGCCCGATTAGTTTTACTCGTCGGGCTTTCTGCTTTTTATTCCTCAAAAAACAATAACCCCTTTTATTTCCGCTACCTGATATTTTTTTGTACTTCATCCCCTGCCCACTGGTTACTCTCTTCATCTTCCGATACTCAAAT
X_nematophila_RAND_79	CACTGGAGTGTCTGGAATTTATTTTGGTTCATGAACTAGTGCATCTTTTAGAGCGCAAACATAATGAGCGATTTATGACTTATATGGACGGCTATTTACCTGATT
X_nematophila_RAND_80	ATAGCGATTTCATTATCCCGTAGATTCAAGCTCGGTTTTTTAGGTTGGAATGTATAAGCAATAAGACCGGCAGCAAC
X_nematophila_RAND_81	GCAAAAACCAATATTGACCGCCATATCCAGACCATGCGCACCAAAGGCCGGACAATTTATCAGGCAGCACATGAAAATAGCACCGACAGTCAGGAATGGTCACAAGGCACTTTCGTCAAACCAACGCTG
X_nematophila_RAND_82	ACCAAAAAAATTTAAATAGACTTAGAAATACCATTTCTACCTATAATCATAAATTACGAATGAAATTTAATGAAAATAAAAATGA
X_nematophila_RAND_83	GTTTCAATTCACTATTTCTTACCATACTTCTGGGATCGGGTAATCTTGACACATCAATTTTACCACTATTGTTTTGTGGAAATTCTTCAAC
X_nematophila_RAND_84	TGAAATATGTCATTATTTGGACACTGGTTTTTCATGATAAATGGAATGCTTTGACGCGAAATGAACGGAAGAAATTGCAAA
X_nematophila_RAND_85	TAACAGATTCTGGAAGGCTCCAGTTGACAACATCAAATATTTCAGCCGGAGTCAGCTTCTGTTTTAACTGATTAGAA
X_nematophila_RAND_86	GCCACTGGATTTTTGTCTGCTTTGTTCTTCAATCGCTTC
X_nematophila_RAND_87	ACATGTAGCCAGGCACCTGACCGATGCGTGATAGCGGCGATCTCGTCCACCGGCTGAACCGTGCCTAATTCAGAATTCACGTGAGCAATGCTGACAATACGAGTGGCGGATGTCAGTTTAGCCATGACATCTTCCGGTTGCACTCGACCATTGGCAGCAACTGCAAGGTAATCGACAGCAAGGCCCCGGCGAGCTAA
X_nematophila_RAND_88	AGAAACGAATGAATTCCGTTCCCTGATTGATGGCGATCTGT
X_nematophila_RAND_89	GCCATAGATATGCTGATACGCCACTTATCTCTCCGGTTTTTCCGTAAACCGACAGAGTCATAAGCTACAGGGTTGTTAGCATGGCTTCCGGCATGTTTCTCGGCAACTGGCATTGTATCCATCTTCTATGCTCTTAAGTTTATTGCAGAAATAGTGGGGGAACTGTTCTCCCACTATTCA
X_nematophila_RAND_90	CCAAGGCAATAGCAGTGAGTCGCGTTGGGAAAATCTTAATACGTATCTGCAACGCGATATTCATTTTCTGAAAAGCCAGTTGG
X_nematophila_RAND_91	CATATCTGCGTTCAAACCGGGGAAAGCGGCTACATTGACTCCCCAGTCAATCAGTTGCTGAACCGATAAGACGGGTTGCAGCTT
X_nematophila_RAND_92	TTCAAGGCTAAATATGTGGCTACAGGCGCGGCTACAATAGGTACAGTGCAAGCCACCACGACCTTTACACTACACTACGAGTAATTCTTTACTCTTTC
X_nematophila_RAND_93	TTACTTTAACCTTTGGTGTAGCACTACTTAGCCCACAATTT
X_nematophila_RAND_94	TTCTCGACTTTACTACGTTTGTCACTGAACGTCGCTTCCACACGAATTATTCTGATGGAAGGCCATACTGGTT
X_nematophila_RAND_95	CAGAACAGATAAAAACATTGATGACTATTTATACTGCCACCGGCATTTGGTAGAAAATGCCTTTGCCAAAATTAAACATTTCCGAGCAATAGCAA
X_nematophila_RAND_96	GTTTTAATACAATTATTCAAGGATTGAATGATGTTAATTTGCCTAAAGAAGACAATGAGCTTGAGCGTTCCTTGCAAGAACTAGATGACTTCAGGAATTGCTGGACTACCTTCAAAAGGAAGGGATTAGGT
X_nematophila_RAND_97	TGTCTCGAATTATAGTACTGATCGGCCCAAATAATGCAGGTAAAACTTCGTTAATCAAAGCCCTTCAGCTAAGTTTAGGTGATTATTCTCGCTATCTTTCGGAAGAGGATTTTT
X_nematophila_RAND_98	GATGATGCCATACAAGATAACGATATGATTTATGCAGTTATCTGTGGTTCTGCGGTCAATAATGATGGTTCTCACAAGAACGATTATTACGCACCATCCGCAGTCGGGCAGCGCAATGTTATCGAAGAAG
X_nematophila_RAND_99	CAGCGTGTCTGTTTCGCAATTCAGCAACAATATCAGTCCATGCGACCTGCTCCCAT
X_nematophila_RAND_100	TCGTTCTCCCGTTGCGCTGTAACGTATCCAGTACACAGCAGGGTGTTCTCTGGCTGTCATCTCTGCGACCAATTTTTGGCGGATATCTTGTTGGCACCGATGACTGGCAGAAATTAATCGTGCAT
X_nematophila_RAND_101	CCGATTTCTGATGGTAATCGTGAACAGAATGCTCAGTTATTAGTACTGTCTGCGCCGACACCTG
X_nematophila_RAND_102	GCTGGCTCACATTCCGGGAATTAATATTGCCGTTCCTACCACACCGGCAGAT
X_nematophila_RAND_103	GCTGCCACCAGCTCCGGATTGATGCTCAATACATTGAGATGGATGGATTTGTCCAGACACCGGTATTTATGGCACCGCCTTACCACCAAATAGATGATATTGCCTATATC
X_nematophila_RAND_104	ATCTGCCCCTCGTTAAAAGGTAATTGGTACTGTGCTCCCTGTTTATCAGAATACATAACCACTCCTTATCTCATTCATTGAGCAACACATTGCGCTCA
X_nematophila_RAND_105	ATTGATGGCCAATATCCTTGTCATTGATGAACAATTTCAACAGGCACTGGCTCAAACGGATAACAGGGATGAGGCAGTGAAGAACTTTTGGGAAAC
X_nematophila_RAND_106	GACACTTATCGCCGATGTCAAAAATTATCCCGATGATTATCAATGGGAAA
X_nematophila_RAND_107	CCGTCGATGCGACCTCCGGGGTGTTTTATGCCACCACCACCGACCCGTCCGGCAACAAGGTGCGCCACGGCTTGGACGGCATGGGACGTCTGCTCCACATAAAGAAAAATGACGTGGATATGGACAGTAAAAATTCCGAGCCTGAATTCCTGATGCAGCAGCAGACCCGGGATGCGCTGGGGCGCAGCCTGACGGGA
X_nematophila_RAND_108	CGACACCACTACGTTCACGATGTACCTGTTTGAGAACAAAGACGACCAGTGCCAACTGACGGGGATAAGAACTGACACGGGTACCACGACATCGCTGAAGTACGATGACGCCGGCCGTCTGACAC
X_nematophila_RAND_109	ACGTTCACGATGTACCTGTTTGAGAACAAAGACGACCAGTGCCAACTGACGGGGATAAGAAC
X_nematophila_RAND_110	CAAGAAACTGGCAATGGGTGGGCACAGTGGCCCTGAATCCTGAGCGAGAAAAACAGGCTGCTTAAATTCAAGGGTGCCAACTATGTTGACAATTACCGCACCCTGGCGAGATTTACCGCCCGATTATGGCGA
X_nematophila_RAND_111	ATCCTCTATGGATTTCTACCCTCGTCGGGATTGTAACTATCAGTTCTGCCGGTGTTGCTGGGGTTGGCGGTGGGGCTACATTTGCAGCACTGATCGTTTTACCTGCAATGG
X_nematophila_RAND_112	AAGTGCTGCTTTGGAGTATAGCCTCCTAATGCCATATTGGGCCTTTCATGATTATAAAACCACGGCCATTTTGTCGCCG
X_nematophila_RAND_113	CAAACCATTATTCTCGGCAATATATTGGGTATTTCTGATGAGGATCTTTTACAAGTCGAAATTATCATCGCAATTTCTTTTGTTATCTTAATGTTACTCTGGAAAGATTTATTAGTTGTTTTCTTTGATGAAACTCATGCCCGATCCATCGGGATATCACCATTGCGGTTAAAAATCATTTTCTTCACTTTACTCAGTGCCTGTACCGTTGCTGCATTACAAACTGTCGGCGCTATTCTGGTTATCGCAATGGTTGTCACTCCAGGTGCAACAGCCTATTTATTGACAGATAAATTTAAGCATCTCCTCATCATTGCTGTCGCGATTGGTTCACTGACCAGCGGCTTTGGTGCCTATCTGAGTTATTTTCTGAATGGAGCAACCGGCGGTGTGATTGTCACAATACAAACTGTGATTTTCTTGCTCGCATTTTTCTTTGCACCCAAACACGGCATGCTGGCCGCCCGCAAACGCGCCAGAAAAGAATCTCTGACATTGACTCAAGCGGGGCGTTCATGAATACGTTTATTGAATTCATTACTGAGCCTTTCATGCATGATTTCATGCGTCGAGCCATCTATGCTGCCATTA
X_nematophila_RAND_114	ACACCACGTTCAAAACGATGAGAAGCATCTGTATGCAGGCCAT
X_nematophila_RAND_115	ATTCCAATCACAGCTCGCCGTGTTGTTACTTTTCGCCCAGGCCAAAAGTTGAAAAATCGGGTAGAGAAAGCTTTACCCAAAGAATAGTAACATGAAAAAGGCCGCATAAATGCGGTCTTTTTTTCATCTGTCATATTCT
X_nematophila_RAND_116	TAAATGGATTATGGGGATTATTGCCTTTGGATTTTGGGGCGTTGTTGGTTATCTGTGTTTCACACATGATGGCAAACATTGGTTATGGGCTGCTGCTTGTTCAATTG
X_nematophila_RAND_117	CAATCAAGCACTGAGCATAACCCAACATTTCACAACCCTCTTCCACCATATTTTTCACAGTTCGGTTGAAATGCTCATCCATCAATCCCTGCCATAATACGCCTATACCAAAT
X_nematophila_RAND_118	TGGTAATCAAGATCGTGTAGCCGTAACGTATGCCGGTCTGCCTGCGGATCTGG
X_nematophila_RAND_119	ACCTGATAAAACAAGCAACCCGGTGCTCCCCACATAATGGCGTGGATAAACTCTGAGGCTTTTTGGGCCAGGAGCGGATCAATATTATGTTGCGCTGCTATAATAAATTGGCTGTTATACAATAC
X_nematophila_RAND_120	ATGGAGTAGATGTTATTCTGGCGGAAATGAGTGATAAAGTTGTTACTCAACAAGAGAGTTATAGTCATCCTTTCCCGCAGGAATTGAAGCAAAAATTGCTTTCTATT
X_nematophila_RAND_121	GGCATATTTACCATTAGAACCAAGAGATGTAGCGTTGGTG
X_nematophila_RAND_122	ATATTTTTCTTATTCATTGGCTTTTAGGAATTAAAGATTCAGGAATCGTGATTTTATAGCGTTCGTCATACCGTCCTTGGGTCACAACTTGGCGCTTACCTGAGCCT
X_nematophila_RAND_123	TTGCCAGTACTCTTTATCAAGATGAAACAAGGGAATCGAGCTAATTTGGCTTAGTTGCCTGGCAAAGGTTGATTTTCCTGCTCCAGGAGAGCCAATTACTAGGGCGTGTTGACGTTTTATGAA
X_nematophila_RAND_124	TATGTAGATGAATTTTTATATTTACGTGGGGATTCTATATTAAAAAACGGGTTTAATCTGCG
X_nematophila_RAND_125	GTAATTTGGGTGAGCGAATATAACCTAAATATAATGTTATCAAGATGGAAAATGATAATAAATAGGTAGTGAACTGACTACCGTGTGATGATACGTTA
X_nematophila_RAND_126	CATCGGAATGTTATGTCTTATCAATGTCCTTTATGTCACTTACCG
X_nematophila_RAND_127	CGACCACATGGCCATTAAAAAAGTAATTGGCGCCGAACAGTGCGACCCCAGCCGCTGCCGCGCCACCTACAT
X_nematophila_RAND_128	AAAGTTGCCCTTAGGTTTTGGCTTCGGAACATAGCGGCACGAATTTGCGCGCGCTCATCCTTTAATGTGAAGTACCAATGTCCTGATGATGGCTGAGAAAAATTGGACATTTCGGC
X_nematophila_RAND_129	ATATACCAATCAAAAAAACGAAAATAAGATATTTTCTATCGTTTAGGATAGAAAAAGAGGGAATGTGATGTTTATTAGATTGTATTGGGTTTAGAATGGTTTTATTAGATTGCTTGATAAATTTT
X_nematophila_RAND_130	TTGTCAGCGTGAAACCCTGCAAAAAATCAGTGAAAAGAAAGCCCACGTCGTTGTTCAGGTGAAGAAAAACCAGCCCCGTCTGTGGGATGCCGTTCAGTCTCAGTTTCAGTGTGTGTTTGATGCAGGAAAAGAAAAAATTATCACTGAAATTAAACAAGAAGCGCATGGCCGCCGGG
X_nematophila_RAND_131	AAAAGTGCTGTCATTCTTAAGTTCTAGAATTTTATTTTTCAAA
X_nematophila_RAND_132	TGTATAGCAAAATCAATATAGTCAGACATAAGTCACATGCTCTGTAAACAGCTCATCAATAGAGCATCTTTCTCGTCTTCTTGTGGTTTTTGTTTCAGCCCATTTGTTTTCGATAGGATTTAAATC
X_nematophila_RAND_133	CCAATAGCAAGCAGTTTTTCTTTCCCTGCAATGCGGTATTTCAATCTCCAATATTTGGAGCCATTCACCTTTACCAACAGATACAAACCGCCGCCATCCGATAGCTTAAAATCTTTCTCTTGGGGTTTTACTGTTTCAA
X_nematophila_RAND_134	GTATTTTTTTAGAGGGTACAGAAAGTTACCCCTATATATACCCCCTGACTGG
X_nematophila_RAND_135	TTGCCGGCATTGGTATTACTAACCAACGGGAAACCACCATTGTCTGGGAAAAAGAGACAGGTAAACCTGTTTATAATGCGATTGTA
X_nematophila_RAND_136	GGTAACAGCGACGGAACAAAAAACTTTGAAGGGGTGACATGGGAGTTTCGTCCGGGTAGTGAAATTCAGGAATACATCAAAGGCATTCCGTCCGTGGATAATGAGATTAGCGTTG
X_nematophila_RAND_137	GAGCCAGCTGGTTAGTACGCGCATTCAGTTCCGCATAACTCAGGGTCTTATCCCCTGCTATTAATGCCGTCGCTGTCGGG
X_nematophila_RAND_138	GGTGGGTGCATGGAAAATTTTATACCATCGAAAATCGGGCAATGGGAGGTTTTCAGCCTCCCATTGACTCTTTCTTGTGTTTTATAAAATAAACCGGCTCAAATCTTCATTGGCAACCAGTTCATCCAAGTTTTCTTTGACGTAATCAGAATTGATTTC
X_nematophila_RAND_139	CTTCAGTACTTGATCAATGTATTCTGCCTGACTCGCTTGAGTGATTCGGCTGATTAAGGCGCCTCGTTGCTTGGGAGTAAGCTGACTGCCAAAAAACAGGCCTTTCATCTCCAGAGCCGACATCCTATCGTCAAACCCTGGAATGCTGACATC
X_nematophila_RAND_140	CGTAACGATGCGGCACATGGGATCTCTTCGCCTGATCTGGCCACCGCACTCAAGATCCACAGTTACC
X_nematophila_RAND_141	GGAGTTAAAAGAGCAGAACCCGG
X_nematophila_RAND_142	TTCCACAAAATAAATAAATTCACATCAAACGCTATCAGACGATAAATAAAATACCTCAATAAAAAACACCAAGGAATAAAGTGGCAGAGGAGCCTATTTATTTTCTACAT
X_nematophila_RAND_143	TCAGTGCAGTCCGCAGGGATGAGATTGGGCGGCACAACAAAATCACGGGTGTCATTTTGAGAGGCCAGAATGGATTGAGCCAGTTCGTTAAGAACCGGTGTGGCAAATACACTGCGGACGTCAAGCCGCCAGCCGAAATTGTGCAGTTGTTCTATCAGGTTGACGATCATCAGTGAGTGCCCACCAAGCTCAAAGAA
X_nematophila_RAND_144	AATCCGGTAGAACCCGACGTGTAGATCACATAAGCCAGATGAGATGAAGTCAAACCCAGTACCTGCGCATCGGGATTATCAGAGGATTGCGTTCCTGTGAATGATAGTGTACCTGTGCATGATCGTGTTCTT
X_nematophila_RAND_145	TGGTCGCTTAGTGTGTTAGTACGTGAGTTGGGCGCGTTCTACCGTGCGGCCCTCAATGACGATGATGATCCTTTGCCACCGTTATCCATTCAGTATGCGGATTATGCTGTCTGGCAACATGATATGTTGCAAAGTGCCAGCCTGACTGAACAGCGTGA
X_nematophila_RAND_146	AATAACACACCGTCTCAAACGCTGACGTTACCGGGTTTACAACTCACCCCGGTTGAACAGAAACGCCGTGGCGCCCATTTTGACCTGGCGTTATCCCTGAGTGAAACAGAAGTGGGTTTAGCCGGT
X_nematophila_RAND_147	ACCAGCAAATAGCGTAATTGCCCATACAGGGGCTTGAGCGTGTCGAGATATTCATGGAACAGACCTGCGGTTAACCAGAGCGCAGTGACTTGCCCTTGCATCAAGGAATCACAGAAACGCACCGGATCAAGC
X_nematophila_RAND_148	GCAGGTACAACAGGCTGAATCACAACCTGCACATTTGCTCAACGGCTATGGCCCGACGGAAACGACAACATTTGCCACAATTTGTGTGATTGCGTCTCCTGTTGATATCGCTCACGCCAT
X_nematophila_RAND_149	TTTTATGAATATTATCTTGTGCGCAGTAATGTTTTTTGTAATAAAATTATTTAATTGCATGGTTTTTT
X_nematophila_RAND_150	ACAGCCATCTAGATTTACGTTTGCTAAAGAGAGGATTAGTCCACCTCACCGCAAAGGCCGCAAATATTCATGCGCGTGCATTACTTCATTTAGAATAATGACTAAATATTAAATATCTTTAATAATTATAATATTACACTTAAATCTTAAGTTAAAAAATCAAGAAATGTTGTAGTAGTACAGTTGCATCAATGCAGAGAGCTTATTCCAATGG
X_nematophila_RAND_151	GCGCATTTGGCAGTTCAAAACCGTTGAAACATGCTGATAGACATCTTGCCATCCACCGAAACAGGCATGATGTTCAATTCTTTCCATGATCTTCCTCTCTGAGTTGTTTACTGTGATGGTTTATAAATGACGATACC
X_nematophila_RAND_152	CCTGCACTCGGTGGCGCCGTTGGTTTTATCGGTGTGGAAAAAATCCGGGAATTTGCGATACGTGCAATTAATAAACGT
X_nematophila_RAND_153	AGTGCAACAGCAACAATAAATGACAGGTCGGGAGTGAGGATATTTTTTGGTTCCGGAAATCATGATCGATTACATAAAGTAACTCTTCGTTATCCACACTCATGGAGCGGAGA
X_nematophila_RAND_154	GCGTTAATGGGTAATAACATAGGATGCTGAGCACAAATACCGACGATACAGTTGCTATAGATAATTATTTGTTAATACATAATTAATGTATTTAAAATCACACTGATCAATATAGTGGTTATTTTGGATAGTGCA
X_nematophila_RAND_155	TAAATCTATTCTTGATTTGGGATTGACGATAGAATATCTGGAAACGCATGGTGTACCTCTAGTGGGTTATCAGACAGAAAAACTCCCCGCATTTTTCTGTCGTTCCA
X_nematophila_RAND_156	AAGATTACCGAACGACTAATACGGAGGTTTTTGCATATCTGACAACACCAGAGGAGTTGGAGCCCAATAGATGTGTAGTGATGTTAGGCCGCCTTGAGCCAATGACGATCAAATCAGCATCAATTTCATTCGCCGT
X_nematophila_RAND_157	GTGAAACAGATGAACCTTTGCATTAGATATTCTTGCCAAGTACGTTGCATGTTTAATTGCGTTATCAGTTAGCTGACTTTCTGAAATATCAATTGGAACTAAGATCGTGTTATACATACACATTCCCCTGTAATCAGATATAACTGTAGC
X_nematophila_RAND_158	AGCCAAAATAGCTGCCGGTATAGAGACGATTTTCGACCGGAAACCCTTCA
X_nematophila_RAND_159	AGGGGACAACCGCCTGACATTTTTAGTGTT
X_nematophila_RAND_160	GTCGTCGCGCTGTACCTTGAAATCCATAGGGTATTAATAAAAGGGGTAGTTTACCCATCTCAAAGCCTGAGTACAAAAC
X_nematophila_RAND_161	TCCCTAACTATTCTTTCCCAAAAAACCAAAAAAATCTTTCATTTCATCCATTACCGAAACCTTATTTCTTTATTTAACAAAGATAAAATACTTATATCTGACTGAGAATTAACGAATCAAAAATGTTTTTTGGCGATCAATCGAAAGAAGAATAAAAAATCATCATTTTTATTTATTAGTATAAAATGTGACTTATATCACAAATGAGTGAATCTTTATTAAAAGAATTATTCTATCCTCAATATAGACCCACTTTTCATTCACATTGC
X_nematophila_RAND_162	GTCGAACAATGTTCCACCTAATGCGGATAAAACACAGGAAAGGA
X_nematophila_RAND_163	CCCGGAGCGAGGACTTTAACGACAATCAATCCCATTAACCCAAAGCAATAAGCAATTAATGCCCGTTGCGTCATTTCAGCATCAAAAGCAGAAAAATTACCGTATTGGAAAAGTGAAACCGTCAATGGTTCTGCCAACATACCTAA
X_nematophila_RAND_164	CCTTCCGATGTTGTGATAAGTGGAAAACATGTCTAATACTATAGGGTAAGAGGTTGTCTCTGAACTCAAAAATAAGTAAAGAAGA
X_nematophila_RAND_165	CATTGATGAAATTCATCGCTTATCGCCTGTTGTGGAAGAGATTCTCTATCCTGCGA
X_nematophila_RAND_166	GCAGCGCAAGCCCTCAATATGTTAAATGTCGATTCAGCAGGGTTTGATTACCTTGACCGCAAGTTATTAGTTGCCATTATTGATAAATTTATGG
X_nematophila_RAND_167	AATCTTGTTAAGATCTGCGTGCGTTTCAACCAGCGATCTGTTCCAT
X_nematophila_RAND_168	CCGGGCAAACTAAAGTAGAGGTAAAAAGACTTCTGACTGAACCGGCAAATGAACAAATGATCCACCGTACTGAATTTGCACA
X_nematophila_RAND_169	TTCAATATCCGCGCAGACCACTTTCTGACATACAACATGCCTA
X_nematophila_RAND_170	AGTGAAATAATTGGAATGCTTCCCCTGCTGAGCTGGGTTAATCCGTGAG
X_nematophila_RAND_171	ATAATCTGATTCTAGAGATTAGTCTGACTAAATTTAGTTTTTCCTGTTTAATTAAAAGGGAAATGTTTTTTGTTTTTATCTCAAATTTTGCTGA
X_nematophila_RAND_172	AGTACATGAAGGCTAATTAATGCACCTTGACAGATATAGAG
X_nematophila_RAND_173	GCCATATTTTGTGGCAAGCTGAATACACCGGCACCAACCATAGAGCTGAGCACCAGTGCTGTCAGAGATGTGAGGCCTAATTTCTTTTCCAAAGATACGTTCCTAAAAATAATATAATCGACACGATTAGCCAGAACTCTTGCTCTGAATATCGAACACATATTGGACATTTATTGCATCCATGCTATGGATTGCAGAAAAGATTTAGTAGATAAATCTAA
X_nematophila_RAND_174	TTTATTTAGTAAGCGAAAATATTTGCGACAGTTAGCATTATAAAATGTAATAATCAGGTTGATAT
X_nematophila_RAND_175	TTTGGAGTGAAGAATAAGATAGGACTTTAGTCTTTAAATAAAAATATTTTGAATTATAATGAATAGTCATAGCCACAATTATAAGATTAAAATAATTAACATTCATACTAACACACTATTGTTAGCTGTCGTCATTTGCTTTTTTTATTTGTGTATCAAAAAACAATGAAATACAGATTCTTTTATTAACTCCTCATACATATTTTATTACCCTTTTATTTTATGAAATATAATCTTATGTCATGGCAGTAAAAAAAGAGCTTCATATATCATGTAATAA
X_nematophila_RAND_176	CAGCAAATCCTGCAACAACGCGGTTGGTCGCATGTCCAGTTACGTCAGGGGGATGCGCTGAATTTGGGTATGATCACGCCCGGCATGTTCGATACGGTTGTCATTAACTCGGTGGTTCAGTATTTCCCCAATGTCCAGTATCTGGACAATGTTATTGCTCAGTTACTGCCTGCGGTTGAAGCAAGTGGGAAAATTCTGCTGGGGGATATCC
X_nematophila_RAND_177	CAGTCTGTTTAACAGCGATACCATTGACAGATTACTCGCTAATTACGAAACCCTGCTGACCAGCATTGTTGAGGCGATGAGCGACCATTCGGTTAATAATGAGCCATCCGTCCATGATCTCCCGTTTCTGGCTGATGCAGAAAAACATATGCTACTGCATGAGTTGAATGGGCCACAGGCCCAGTATCAACGCGATCTGTGTTTCCATGAGTTGTTTGAAG
X_nematophila_RAND_178	TGGTTGTAATTTGACGATTTGTAAATCGATCGTCATGTTATTGTCTGATTTCACGAAGATCTGTTCATTTTCTTGATGGAATTTCAAACGCAAACTTTCATGCCGTTCTAAAAGAG
X_nematophila_RAND_179	AATTTTTATAATCCGATTAACATCAACAGGTGGTTCAGATCGGATTTTTTATTTGTTTTCTCTGTAAATATAGATTGGTTTGATATTTTATATAAATAAAATGATTA
X_nematophila_RAND_180	TGGCGTTTCTTTCTTCTGGAGAAAGCAGGGTGGTCATTTCATAGGAAAGGTCATATATAGGTAAAAATGCCTTAATTCGACCGCCATTACGCTGAACGATATAAACTGCGCGTCTTAATGCTGGCTGATCATCTTGATTGGGGTCAATTGCAACTAAGAGATTTTGGTAGTTTGCCATATTGAGTTCCTCGCGGAGTTTGGATGCCTCTTG
X_nematophila_RAND_181	GTCAATTGCAACTAAGAGATTTTGGTAGTTTGCCATATTGAGTT
X_nematophila_RAND_182	AGTGGAATAATGTTTTCCTGGCCAATACCAAAGATATCAG
X_nematophila_RAND_183	TTTTCGCCTCTTGGTCAACTAATTGATTTAGTTTCTTGATAAAGGTCACCTGAAGCTGCTGCCAGTATTCTTCAAAATTTTCTTCATCACGCAAACAATACGTCATGACTGCTGCACGTAATACATAAATGCAACGGACTTTTTCCCATTCACTGCGGCTAAAACCACATTTTTCGGCATAATACCATGGAGTATTA
X_nematophila_RAND_184	GTGGCATCGATTTTGGCAAACGAATTGATA
X_nematophila_RAND_185	CTCAGTTTATTGCCAATATTCCGGGAATGGGTGGTGTAGTTGAAAAAGGCACCACGGTTGAGCGGGT
X_nematophila_RAND_186	GCGGTGGTTTTCATAACATCAGCTATTTGCCCTGCATCCATATACGGGAAACGCTGCATCAAG
X_nematophila_RAND_187	GCTCGTCCTGATTGATATCAGGACGAGCTTTCTGAAAGTATCTTTAAGAAAAGATATATGTATTTGTAAAATTAAATATAACTTCAATAAAAGATACTTCCCCTGACTATCTATTCGAAAAATGTTCAATTAGTTGATTCATTGGTCAGC
X_nematophila_RAND_188	GCTGATGCGGTAGAACAAAATGCAGAACGTTTGATTGAGGTACAAAGCCGCAATACAGGGCAGCTCAAGCATCTGATTGCCTCTGAAGAAGT
X_nematophila_RAND_189	CGTTGCCCGTGAGCATCCCAGATTTCAGCATTTTCTGCACGATCAACATAGACTTGTGTAGTCACACCAACGCCTTTTGCGATAGCCTCACTACGCCT
X_nematophila_RAND_190	ACCGCACTGCCAGTATCCTGTCTGATTCCCTTCACTTTCGTACCGTCATAAACGCGTCCCCCCAGTCTGGCAAAGCCATAAATCAGGCCTCT
X_nematophila_RAND_191	GTCTCACGCCTGACGGTGAAATATTCTTGATGAACTGTCAAAATGCCATTGATATTCTTGAACAAGCTGAAGCCGATCTCACTTCGCATATTGCTTATCCCTCGGGAAGACTCCGTGTCGATTTGATTGAGGCAAGTATTGATCTTGCTATACGTATTGGTGAGTTATCTGATAGCTGCGGATTGGTTGCCCGTCGATTAACGGTTCAGAAACTGATTATTTGCGCCTCAC
X_nematophila_RAND_192	CTTGGTTGCTGCCCTTTTTCTGAAGAATAACATCATAGCGATAACGCAGCATTTCATTATCACCCACACC
X_nematophila_RAND_193	CCCGCCAGGGCCGTTCCCACCAGAATATCTTTTTCATTGCTGTA
X_nematophila_RAND_194	TTTTATAATTTATTTAACATTAAATATTATTTTCATGTAATTTCACTTTGGTTAAAAAAAACACCTTGAATTTTATACGATATCCTATC
X_nematophila_RAND_195	CACTTTATTGAAGGAACGACAGGGAAAAATCGTACTGTCCCTGACAATGTTGATCTGGACACGCTAAAATCACTGTTTAACGGCGCTTATATAGGTAATAACAATTATGACCT
X_nematophila_RAND_196	TCGATGTAATCCGCTGACCTGCACCTTATTCCCCGAACGAGCTTGACGCTCTGGTGACCATTCAGGTTTAGCAAGTCACGGTCTCACCTTTCGTTGTCATCA
X_nematophila_RAND_197	GCAGAGTCACTGAAAAAACAAGCGGAAGAAGCCCGTTTATTGTTATCGGTATTTCATAACCGTCGTTGGGATTCTGGTTTCCTGACAGTGAAATCACTCATTAAAGAAAACACCTTAGGAGAATTGAAATACTATGAATCCCACTTTGACCGTT
X_nematophila_RAND_198	AAACCCGAAGCAATTAAGGCGCTGAATAAAGCTCTCAAGGGTAATAAGACTATCATTGTCCGGGTGATCCCGACAAAATACCCTTCCGGCGGTGCCAAACAACTGACAAAAATCCTGACAGGTAA
X_nematophila_RAND_199	AACAACTTTATTGGTTCAGTCGCGGCCAGGAACACGAAAAAGCCAAGAACCAC
X_nematophila_RAND_200	AGGAAGGGCGAATCCATATGAACTATTTCAATCCGCAATGATTTGGCCCAGCTACCCAGCA
X_nematophila_RAND_201	AGTTGCGTGTTGACACAGTACGCACGGGGCGCGGATTTGCAT
X_nematophila_RAND_202	TCCAACCATTCCTGCGCCGAACTGCGATGCGTCAGTATTGTGCGGGCACCGCACTGATTATCCATCGTCGTCAGCAGGTACGGCTTGCGGGAGGACAAGTCATAACGCCAGCTCAACGGATGCAAATCCG
X_nematophila_RAND_203	TTGTATCAAGGCAACTGCATTATTTTATTACTACTGCACAGACACTCTGTATTACCAAAGCCGCCAGTCGATTGTATATTACTCCTTCTCCACTGGGGCGCAGTATT
X_nematophila_RAND_204	CGGTCTCAACAGAACTCGCCACTGAGGATCCAAACGCAATCGCGGCATTGATGAAAGAATTTCCATTGGCACAATACCA
X_nematophila_RAND_205	CTCGATTAAATTATTGAGGTATTTATTTTGTCGCACCACAATGGCTTCTTCTTCAGGTTTACCCCTATTAAGCGCTTCCCGGGCTGCTGTGTTAGCGCTACTTTTGTCGATCGTCACCC
X_nematophila_RAND_206	CGGTTGATGAAACTCCATGTATCCGTCGGCGTTACAGGTCTGCTTAATGAACAAATCGAGCATCACTAACAAAGGAAACGCATAGTAGTGATAGTGCATGAAAGAACCATCACCACCGTCCATGTCGCCCATTGCCGTGATGTCCTTGGTTAGTCCGGTCA
X_nematophila_RAND_207	GATCACTTCCGCATTCTGGCACCCAGGGTCAGCCGATACCGAACTAACCCAAAAAACCGCGCTAACGGCCATGA
X_nematophila_RAND_208	TAGCAATTTAGGACTCTGTGGTGCAGAAGGTGACAATGTTAA
X_nematophila_RAND_209	GAATAGCTATCTTTCACCTCGCCAAAAGGTGATGTTTGATAGCATAACCAATGCACCGTCTTCACCTTTTGGTGTTTATGATCCATCCAGCACAAACAACTTGGGTCCTGGACTGTCGGGATTTGTTGCTTATACGGCTGGAATGA
X_nematophila_RAND_210	CCCAAGTTGTTTGTGCTGGATGGATCATAAACACCAAAAGGTGAAGACG
X_nematophila_RAND_211	TTTTTCCTCAATAAAACCCTGACGAGTGCGGTGCAAACATTGCATCGCCAGTTGGCTTTCATCC
X_nematophila_RAND_212	ATATAATCAGACATAAGTCACATGCTTTGTAAACAGCTC
X_nematophila_RAND_213	TCTTCAGAAAAAAATGGCAAAGCGACCGGATGGGCGGCCTTTTTTGTTGAAGGTTCCTGGGCGGTAAAAGAGAAATAAGGGTTTGAT
X_nematophila_RAND_214	TGATTTGCCGACGAGTGGAGCGGCGAGTCAAAAGAGTTCAATCTCATCGACTGATAA
X_nematophila_RAND_215	CTATAAGGCCCGCATGTCCATGTGTAATCCTCCATATTGAGTTTCGCAGAACAATCATCATGACCACTAAACGCTTTTACTGTGACATTTTTGGCATTACTCGGCATTGTGCCACTAAAGGTATATGAGGGTGTTTTG
X_nematophila_RAND_216	TGAGCCGCATAAAGAGAAAATAATCCTTCATTGTTTGCAGTCAAAACAG
X_nematophila_RAND_217	GTATAATCTTTATAATCCGAAAGAAATTTTATCTGCCGAAATTGAAAGTCATAAGTT
X_nematophila_RAND_218	GACACTGACACAACAAGAAAGCCAGCAACTCTTCACCGCGATGATCCACG
X_nematophila_RAND_219	TTGTTCCGTCCATTAACCTTGCTGTTATCAGTTTTGTCAGTTTTATGATGACAGCCCGTAGTTTTGCCAGTAAAAATGGCTATCAAGTTGATGCGGATTTAGAACTGAGGGCAT
X_nematophila_RAND_220	GAATTGCTGGAAGCAGGCGT
X_nematophila_RAND_221	TCAGGTGAGTCAGATCCTTGCCTATTATGAAACTGCGATAAAATCAATGTTAGTTT
X_nematophila_RAND_222	GATAATGCCGATAGGGCCAACTCGCGGTGTTATATTCGGTTAACTGCTGAATCAGCGATGCCCAAGTTTGTTGAT
X_nematophila_RAND_223	AGCTTAATGAGTTGCCTCCGGTACATGATTTACTGCTGGATTATTCACGTCCATTGCAACTTGGCAGCCGTGGTGGGCTGGTGGAATTCCGTGCTGACAA
X_nematophila_RAND_224	CCGTCCAACACAACTTGTTCGGGTATACCCTGTGACTCCTGATAGA
X_nematophila_RAND_225	GATAGACATATCAAAACTGAGGGCCGCAAATTGCAGTACCCGATCCTGTTTTGAATAAAGGTAGACATCTGCAAGCCCGGCCACCAGATTCACCAATGCCCGATGTTCAATCA
X_nematophila_RAND_226	TCCAACAGGCAGGATAATTGCGCAAAACCGACTAATCGTGATGCACATTCGCGATGGCTGATAATACATTGTGGCTCTGTATCTGCCAGCATGTACTGCACTCTGTCGTCAGGAAAGTCAGGATCAACCGGAACATAGGCCGCGCCTGCTTTCATCACTGCCAATAACGCTGTGAT
X_nematophila_RAND_227	CCGAATTCCGTATCTGGCATGAGGAAGATGACCTCTATCACATTATGTTTGATCAGCAAACCAAACAGCGTATCCGCATTGATCAGTTTCCGGTTGCCAATCAGCTCATCAATAGCATGATGCAGGCGATTATCGCTGGTGTAAAAGAT
X_nematophila_RAND_228	CCCCGCCATTCCAGCCTCCCCCCGGCAGCCATTTTAAGGTAATGGCGAA
X_nematophila_RAND_229	GTCTTTTACTACATGAATTCCCGGTTAATCAAACCTTATGTTGGTGGCTATACCGGTAAAGACCCACTGGATAATTACCATACTAAAAACTTTTACATAATAAAACATTAAGAATCAGTAGGTGGCCCGGTTAA
X_nematophila_RAND_230	AAGCATGGTTCAGTCAGTTCACCAATAACAACCAAATCAATATCGTGGTTTCGTGCAATGGCTTTCG
X_nematophila_RAND_231	TCGGTAAGAGTAAAATCTGGTCGGTAGTAAAAGCGAATGCGTACGG
X_nematophila_RAND_232	TATATAAATTTAACTACTTTTTTAGATTGAATTTATAAATTATTTATTTGATATTTTTATGTTTTTGGTTGT
X_nematophila_RAND_233	TTTAAAATCATGTAACACTATTTTTTGAATATTTATTTAACAGCCTTCATTTG
X_nematophila_RAND_234	AAATGCCCTGAGTGGTTTGCCATAATCGCGCGTCTGGACTGGCTTTGAACAAAATCACTGCTGGTTAATCATAGGTTTATTTCGCCTGGCTTTTTGCACAATGGGTTCATTTGAAATAAAAAAGATAATATATTTCCGGAGTTATAGCGAAAAATGCAATTATCAAAATTTAATGAATGACACCTTAATAAAATAACTCTTATATTCGGAAATATCATTATACTCCCTATATGCGAGAGCTTTGTTTATTGCTCTGCATTCAAGAGAAAACAATAACCAT
X_nematophila_RAND_235	AAGGCGCAACCAGAGGCGGACACTTGCGCACTCCGCCGGATATCAGCGCTGAATTACTGCATATCACCTA
X_nematophila_RAND_236	ATACCCGTCATTGATTCTACAAATCAATATTTATTAGATCAGTTAGCTAGTCTGAATTCAGGTGATGCTTGTGTTGCAGAATATCAGTATGCAGGTAGA
X_nematophila_RAND_237	TATATCGGGAAGCGAAAGATTTTCATCCTGACAATTCTCAATATCACCTGAATAAACGACGCCCCGACATTGCTTCACTGGCACTGACACAGAATAATATGGATGAAGAAATTTCCACATTATCCTTATCTA
X_nematophila_RAND_238	AAAGGCCAAGCCCTGCGTAAGTATCAACCGTATTTCCTGAATAGTTGGCAGTACGTCAGTGATGACAGTGCCCGGCAGGATATGTATGCCGATACCCATTACTATGATCCGTTGGGGCGTGAATATCAGGTTATCACGGCCAAAGGCGGGTTTCGTCGATCCTTATTCACTCCCTGGTTTGTGGTGAATGAAGATGAAAATGACACTGCCGGTGAAATGACAGCATAAAGCTCAGTGATGCCTGTTCACTGAACAGACATCACTCCATTTAGGAATGAATCATGAAGAATTTCGTTCACAGTAATACGCCATCCGTCACCGTACTGGACAACCGTGGTCAGACAGTACGCGAAATAGCCTGGTATCGGCACCCCGATACACCTCAGGTAACCGATGAAC
X_nematophila_RAND_239	TTGCCAGCGGCGAAAAGCAAGCGACAGGAGATAACCATCTTCAGTGATGATCCCAGCCGGTTTCAGCTCTCCATAAAGCTCCCCATCATTAGAAAAGCTGGCCTGAACCATCCAGCTCAG
X_nematophila_RAND_240	TAACCGATTGACCAGCCATTATCATTACTCACATGGTGCCTGGGATGGTCTGGAACGGGAGTTTCGTGGTTTTGGGCGGGTGACGCAAACTGATATTGATTCACGGGCGAGTGCGACACAGGGGACACAT
X_nematophila_RAND_241	ATAGAGATTTCTTCATTAATCCCTTTTAAAGCAACCACTTCTTCTTCTGTTAATGTTAAAGGTACTGAGTCACGCAATGTTGCCCAATGTTCACGATCAAATTGTAAATATGGAGTTGTTAAAAAAGATT
X_nematophila_RAND_242	GCTTCCGGCAATGAATTAAAACTCAGTAACCGTCAGATAG
X_nematophila_RAND_243	TGTATTACTCAATAAAATCAGTCCCACTCGCGACGGTCAGACGATGACTCTTGCGGATCTGCAATATTTATCCTT
X_nematophila_RAND_244	TAAAGAGGATGCTATTGTAAATGGCGGA
X_nematophila_RAND_245	AAGGGTGTGCTCTACCAACTGAGCTATATCAGCACATCTTGGAGCGGGCAGC
X_nematophila_RAND_246	AACAACACCAGCACCTACAGTACGGCCGCCTTCACGGATTGCGAAACGCAGACCTTCGTCCATTGCGATTGGATGAATCAGGCTAACGATCATGTTGATGTTGTCACCTGGCATGACCATCTCAACGCCTTCTGGCAGTTCGATAGTACCGGTTACGTCAGTTGTACG
X_nematophila_RAND_247	ATAACAAAAACAGATAATTATACAAACTTATGCACAG
X_nematophila_RAND_248	AAAATATGGTGCCACCTATGGTTACAAAACAGTCGCATAAAATGGAGATCCACGGAG
X_nematophila_RAND_249	CAGTAAAAGCAATGGGCACACCTCAGCATGTGACTAAAATAGCGCCAAATGAAAAAGTGGTTGTCTTTGTTATTGCAGAACAGGGTGTTTCTTTGAATAACGAATACGCTGATTTTGTCTGGTTTACCCCCAAAGT
X_nematophila_RAND_250	TCCAGCTCAGTTCCCCAATGATGGCGGCTTGCTCCCGGCAGGGCAGACCAACGGAGGATAGCCTTACACAGTTCACCTTCACTCAATGTTGAGATATCAATCGGTTGACTA
X_nematophila_RAND_251	CTGATTAGACATTAAATCTACCCCACGGCTTCCCAACCATGAAACAATCACACCAACAGCAATCGCGAGCAGCGATTTCCAATTCAGAAAGGCGCTAAAGATTTCTTGTGCAG
X_nematophila_RAND_252	GCGGATTAAACAGAAATTATAATCGCGTTTGCCAAACAAATGCGATTGACCTTCTCTTGATCATTTTTTATGTTTAAACAGAAC
X_nematophila_RAND_253	TGTGGGATATGTACCGCTGGATAAACGTGCCTATTTTGTTCCTGAAGTTCTTGATGGCATGGAACACTTATCTCTGGTGTGTATCGATAACATTGAGTGTATTGCGGGTGATCAAGAATGGGAAATGGCTATTTTTAATCTGTATAATCGGATTGTTGAAATTGGTCGAACTTGCCTTCTGATCACAGGTGATCGCCCTCCACGGCAAATTAACCTGACGTTACCGGATCTGGCATCTCGTCTGGACTGGGGGCAAATTTATAAATTACAGCCTTTGTCTGACGATGAAAAAATTCTGGCATTACAGTTGCGGGCCAAGTTACGGGGTTTTGAATTACCT
X_nematophila_RAND_254	CCAATAACGCATGACACTGGCATTATTATCAAGTTGATGAACAAAACGTAGATCTTCCCGTTCAAGGGGACGTAAGTTGACAGGTAAATTTTTTGAACCATTCGGCATTCTGTACCTCAGTGCTTTTTTTAATGG
X_nematophila_RAND_255	CGCCGCCCTGCGGCATCCCCCTGTTCCGTACCTGCACCCTTCCATCCGGCATTTGCACCGGTGCCTTCAGCCAGCGTTCGATATACATCACCAACCAGCGTTCCTGTGTGTGATGCCGCACTGCTTTCAGTAACAGGGCATGAGCAATATTATCAAAGAAGCCTTTGATATCGAT
X_nematophila_RAND_256	GCAGAATTGCAGGCGTCAAAGAGATGTCCTCTGCCAGCTCATTGGGAACC
X_nematophila_RAND_257	ATGTCCTTTTTCAGACTGGTTTCATTGGCATAAGATGCACTGACACCAATAACCTGGTGATGGTGTGCTTATATTTTGCAAAATGCGCTTGCTATTTTTTGAATCCGCTTTAATTGCAATCGCTGGAATTGGAT
X_nematophila_RAND_258	GCATCCCACCGAAAATAATTACACCACTTGTAATGACCAACACAATGCCGACATAAACAGGTTTAATATGAAAGGCAAAATCAGCCGCTTG
X_nematophila_RAND_259	CACTACATTTCAGCAGATTAGCGTTATCCATCAGGCGTTCGAAATCGTAAGTCACAGTCTTGGCAGCGATCGCGCCTTCCATTCCCTTAACGATTAAA
X_nematophila_RAND_260	AAAATTTCAACGCTAATGCTTTGACCTACGGTAAACTCTGCATCGCCTTCTGACAGACGGAATTCACGCAGGATGCGGCCAGCTTCAACGCCAGCTTTAGCGAAATGACCTGCTTCAGATTTATTAACGCGGTTAGCTTTTTTGCTACCAGTCGTTACCTGAATTGCACG
X_nematophila_RAND_261	TATTTTTTACACAGTTGATGACACAGCAATAAGGGTTGATTACTCATAACGTAAAGCCTCAGCAGGTTGAGTGGCAGCCGCGCGCCAAGAAGGA
X_nematophila_RAND_262	CCAATGTCGCACAAGTATTATCTTCAAACCCTATCAAATCAAAGATACTCGTT
X_nematophila_RAND_263	CCAACAACATCTAACATTACTGGACCCATAGCATTCCTCACTTCTTTTTATTGGTCGCCATCTATAGTTAATTGAAATTAGTTTCCACTCAC
X_nematophila_RAND_264	GCAGGGCAGACGAATTACACGGCAGCGAAAGCAGGAGTTATTGGTTTTAGTAAATCATTGGCTCGTGAAAT
X_nematophila_RAND_265	GAAGTACCATGACTGGAACGAATGGCTTGGGAAGGCCTTGCGTCGTTAGAAACGACATGTTCCGCAGGAATAATTTGCAAACGACTGAGCAGCTCAGCACTTTTGTTTG
X_nematophila_RAND_266	TTTAAACATAGCTGAAGTTGCGACACTTGTTGCAGAATGTCCACCTGCACCGCCTTTCCCTTTAAATGGACACGCAGGACGCTGCCATTCATTGATAATAACAGGTTTTGTTACTATATCTGGTGCTGGTGCCTTCGTCATTGGGGAATAAGCATGAT
X_nematophila_RAND_267	CACCAACAGTTAGTCCCAAATGTACAACGATAATGTCAGCGCCTGCTTTTGTCATTGCTACTGCATCTTCTGGATTAAAAACATAAGGAGTAGTCAACATTTCTTTTTCATGCGCCAAGC
X_nematophila_RAND_268	GTATCTCCCGTCATAAGGTGTTTGATGGAATAACATAAACGCGGGAAAACCTCAAT
X_nematophila_RAND_269	GATATCCCACAAATGAAGCCACTGGTTCATGTATCAGGTATGTTTGGGGCTTTACGTAGCAACATTAGCCTTATTGCGCCTTTAG
X_nematophila_RAND_270	TAATTTATTAACATTTTTAGCTGAAGGTAGTTTATTGCCATTATCTCGCAAGT
X_nematophila_RAND_271	TCCCGCGTAACGCACTTTATGCTACAACTGTGGTAGCTGGATTATGTTTCCTCAGTTCCATGTTTGGAAACCA
X_nematophila_RAND_272	ATACCCTTATCGCAAGATGATCTCAAAAAAGGATACAAGGTATTACCGATAATTATTCCCAATAAAATAGCAAGTGCCAGAACACCCAATCCCATATCAATAAACCATGGAATATTGCTGATATAGATAGCC
X_nematophila_RAND_273	AAAACTGCTGAAATCCTTCTTGATTTTCTCGTCCCAAAAAACCACTGACAGTGACATCAATACCCAGATCGCGCAAAACCTTCGCAACATTATTTCCTTTACCAGCGGCATGAAGTCCTGCTGTTCGTACACGGTTAACGGTTCCCTTG
X_nematophila_RAND_274	TGGCCATGCCCACCACGCGGCGGGAAAATAAATCCATCACCCCCGGGTATTTGGGCTGGCCGGGGCAAAATGCGGCTGCAAAAAATCCGGCGACGCCACGTGCTCTTTCCCCGGTGGACGATAACGGTGGACCCCCGG
X_nematophila_RAND_275	ATGTGTACAATAAATTAACCTACCGGATAAAAAAAGCTAA
X_nematophila_RAND_276	AATCCGACAGAAAACATTTCGCAGTTTGCCCTGTCACTCTCTATGAATGACACCGAA
X_nematophila_RAND_277	TGTACTGGCAAGTGGGCCTGTAAATGTTGCTGGGTCAGCAATAATGCGGGTTTACTGTCTGACAACTGATAGGCCAGTCGTTCGCTTGGGTATTC
X_nematophila_RAND_278	GTTGATTCAGTTCCGCATAACTCAGCCGAGTATCCTGGTACACTAACGCGATTGCGTCAGGATTTGACTCTGCCTGTTGTTCAAATAGCTGGTGGATC
X_nematophila_RAND_279	AGCGGTAAGATCACCGGCATATCTGGCTTTTTGGAATATCATGACGGTTTGGAAAA
X_nematophila_RAND_280	GATTTCTGACAAACCTCTGGAGCCTGAATCAGAAAATAACTTTAACGATTATGTGGAATGGCAACAGAAATGGTTAAAAAGCGCCAG
X_nematophila_RAND_281	CGGGATGAAGTATTGAATTATGTGCATGGTACTCCGGCGATATTATCGCTGCGTCATTTTATGCCTGATG
X_nematophila_RAND_282	CGCACTGAAAAACAGTGTCCTGAAAGGGCGTTCAGTGGGTGTGGCTGCTTACAATGCCAAACAGGCTCTGGACTGGGGTGTTACCGGAGCAGGTTTACGTGCAACAGGCATTGGTTT
X_nematophila_RAND_283	AGTTTGTCCTGAGTGCGGAAGAGCGTGATGCCATTGAGCAGGAAAAACACCACTACGAAGATCCGCGTGCTGCGTCAATTGAAGCGCTGAAAATTGTGCAAAAACAG
X_nematophila_RAND_284	TTAATTTTCTGGAGCATTTTCCGTTCCCTGACGTACTTTCATTCATTGCAATAGTCATGGTCGTGATGTTCTTCGTGACTTCAGCAGATTCAGGT
X_nematophila_RAND_285	TACCTTAAAGAAGGTGGACAGGACTACGATTTAATGGGATGGACGCAAGAACAGATTATCCA
X_nematophila_RAND_286	GTGATGCTGCCATTCTTCTAATTCTTCGAGAAGATGGTTAAATACCTGACTTAATTCATGCAGTTCGGCAATATGGGCTGAGGGG
X_nematophila_RAND_287	TTCCCCCGTCCAATTACATTAGCGTTTTGACCCACATTAA
X_nematophila_RAND_288	TTGCTGAGCAGGATCAGGATCATAAACATAGTCCAGATCAATATGG
X_nematophila_RAND_289	GCCGCCACGGGCAAGCAACCCCGGGTCTGGGTCTGGCCCTATGGCGTGGATAACGGCGTTACTCTGGAGATAGCCAAACGCTATGGCTACAAGATGGCGCTGACACTGGATGATGGCTTAGCGAATGCCAGCAATCTTAACAACGTTCC
X_nematophila_RAND_290	GCAGCTTTACTAAACTCCCAACACCACGTTGTTGGAGTACTCACTCGACCAG
X_nematophila_RAND_291	CGAGTACGATCACCAAAAAAATGATTTTGGCAGTAAACAGTAATCGGTTAATTAAATCAACAGAATGAGTTCCGATACAGACAACTCCACCGCCAATAATCGTAAAAGTAATAATTCCGGCAGAGA
X_nematophila_RAND_292	TCAAAAACAATCCAACTGATATTATTTTAACAGATGTTAATATGCC
X_nematophila_RAND_293	TCATCAAACACAATGGAAGGATCGTTGACGATATTGCGAATAATATGTGTATAAGAACGCGAGTGAATCGTCTCTGAGAA
X_nematophila_RAND_294	CGGCAACGGGCTGCCGTTCTGCGGGTGCGGGCGGCAGAGAGCCTGCCAGCGGTGCCCCTGCGACGCTCTGGGGCACGGAACGTTCAGGCACAACACTGTGTTTGCATGACAGCCTGTTTTGTTCA
X_nematophila_RAND_295	CACTTTTATGGTCCTTAGTAATAGTTAAATACCTTAAAGCCGGAAAGATCCCCGTGATCTTCCGGCTTTGTTCTGTTAAG
X_nematophila_RAND_296	TACCAGCTAATCCCATCTGGGTTCATCCGATGGCGTGAGGCCCGAAGGTCCCCCACTTTGCTCCACAGAGGTCATGCGGTATTAGCCACCGTTTCCAGTGGTTATCCCCCTCCATCGGGCAGATCCCCAG
X_nematophila_RAND_297	ACATCTCGCCAGGGACAGCCTGT
X_nematophila_RAND_298	TTTTCGTTAAGATATTGGCTTTATCATCATAAGTAAAACTTTGTGATAAACCCCAGGAATCAACACGCTGTGTTAGAAGCCCTATGCCGTTATAGGTA
X_nematophila_RAND_299	TCGCCTTAATGGTGTAGAACCGGAGGCGTGGTTGCGGTACACCATCAGCCATATAGCCGATTGGCCATCAAACAAGGTAC
X_nematophila_RAND_300	TATGCCAGCGAAATTAGCCGCCTGAAAGCCCGGGTGGTAAAACTGCAACGTATGCAGTTCGGCCAGAGTTCAGAAAAAATACGGCAGAAGGCTGAACGACAGATACGCGAAGTGCAGGCGCACATCAGTCACCTTCAGGAAGAAATGGCCGACA
X_nematophila_RAND_301	TTGAAGTGCGTTCTGTCGCCCAAAGCGACCATCAGAGCCGATGCCCCCAACGGGCCGATACCCGGCAGTGTTAGCAAACGA
X_nematophila_RAND_302	GCCGCCAACAGGCACTGTATCTGAACTTTCTGCAACCCGCGG
X_nematophila_RAND_303	CCTGGAAGCAGGGCATCAACCACTTCAGCACCGTAGTGCCTCGTTATCACGCCTCAGTGTTATCAGCGGTCCGGATTTTCCAAAACCACCCACCTACACGCTTCAACCGGGACGACCGTCGCCCGGCTGGCCTAGCCTTCTCCGTCCCCCCTTCGCAGTCACACCGGGTACAGGAATATTAACCTGTTGCCCATCGACTACGCCTGTCGGCCTCGCCTTAGGGGTCGACTCACCCTGCCCCGATTAA
X_nematophila_RAND_304	ATACGCCAAGGGCAAGTATCAGAATCACCCGTCACTGTCTATGAATGGT
X_nematophila_RAND_305	AGTTAACTGCTTTCTGGTGTAACAGGAGCCATTTGCGGTCTTGCATAATTTTTTGA
X_nematophila_RAND_306	ATACGGTGTGTGCTGGTAATTGCCGAAACCATTTCCCAATGCCTGTATCACATCGAGATCCCCGCCACGCAGCCGGACGAATGCACCGAGATCCAGATCCACGCCTTTATTGCCTGAACCGAATATCCC
X_nematophila_RAND_307	GGTGTGGGCGAGTAAAAATTATCTATTCAAAATAATGAAAATAACTTG
X_nematophila_RAND_308	AATTCCATTTTAAACAAAACTGCTATCACTTTTACTATCTTATGACAAGAGTATTTTTTACCCTTTGCTGATTTT
X_nematophila_RAND_309	TCGGTCAATACCCTCATAGCGTGGATCATCGCTGTCATCAACTG
X_nematophila_RAND_310	GCATCTAATCTGCATGAACTGCAAGAACAAGTACGTTCGCGTTATGGGGAATTAAGTAAAAGATTAC
X_nematophila_RAND_311	TTTTCCGGGGGGAGTTTTTCCTGAGCGAGGAAATCTTTTAGGTGACGGCTGACCGTACTGTCATGAATACGCAAGGCCCGGGCAATCCTCTGAGCTGTCCAGCCTTCATGAGCCAGAAGCCCGGCCTTGATGCGGTCACAGACCCGACTGTCACGCGTTGTATTGTGCATCAATTCGGGGGGGCATTTTTGGTCTGGGGTCAGATGAATTTTCAGGGTGGCAAGCATGATTTGGTTTGGATAAGAAATCAAGCATCTTCAATGGCGATTGGTATAGATAATTAACTATCATATCGGCACTAATCTCTTTTTCAACTATTCCTCCTTGAG
X_nematophila_RAND_312	TGCACGTATCCGTGCGTCTTTGCCGACGATCGAGGCCGCG
X_nematophila_RAND_313	ACTGTACAAATGGCTCGGCTACAGCCAGCGGGATAATGACCTGCCGCAACCTGCCTATTGCTCCCTGAGCCGGGCACTGG
X_nematophila_RAND_314	ACCGTGCTGGATAACCCGCGCCGTGATCGCATCGAAAACTTTG
X_nematophila_RAND_315	CATCGGCGTGTTGCGATCCCTGTGAGAATGGTCGGTGTGTGGGGTTG
X_nematophila_RAND_316	ATTCTGCGGCGGCATTTAATCCGTCAATCCGCTCATCCAGGGTTAATACCACTGCGCGGCAAGATTCTGTATTAGCCATAGCATCACCTTTATAGTATGGATAATAACGGGGTTAATATTGT
X_nematophila_RAND_317	AATGTTAGCAAGTTCGCCAATCGGATCCGTTTGATATTTCTCACCCTGTTTCAGTAATGTTACAGTTTGGTTTTCAACATCAATCTCAATGCAATCACCGGTGACTAATTTGTCACACAAGCGCGCCTGAGCGGCAATCGGTAACAACTCTCCGGTTGATACACAATTGCGGAAAAATATACGCGCATAAGATTGGGCAAG
X_nematophila_RAND_318	CACGTCATTTTTGTTGCCCATCAGGAACGCCTTAACAAACCGGGCCTGCATCAGTCGTACCTTATGCCCCTGTTTTGTCAGTTCTCGTGCCCAGTGCTGAGAGCCACCACAGGCCTCCATACC
X_nematophila_RAND_319	TTTATTAGCTGAATTAGTAAATGTTTTCGAAAAAAACCATACGCCAACTGACCTTTCCCTCATGGTTTTAGGCAATATGGTAACAAATTTAATCAATACGAGCATTGCTCCTGC
X_nematophila_RAND_320	AAACTCCTCAAGCCACGTCGCCGCTGATGACGTGGCTTTCTTATCTGGATAACCTGCATACCAAAGCCATTGATATGGGGCTTGAGCGCGTGGGTAAGCTCGGTAAGCAATTAGACTTACTGAATCCGGC
X_nematophila_RAND_321	ATCATCTGACAGGGAAAATACCTGTTCAAACAATTGCTGTTTTGAAACAGGGCGTCCCCTGCG
X_nematophila_RAND_322	CATCCAAATCAACGGCCTGTTCATCCACGTATTGGGTACGAAGGCGAAAATCGATGCGGCTTTGCTGGCATTCGATGGTCAATGAAGATGCACCCGCCAGTGTTGCCGCCAAGGGCTGTGCACCCCCCATGCCTCCCAGACCCGCAGTCAATACCCAGCGTCCGGTTAAATCGCCGTTGTAATGTTGGCGACCTGCTTCCACAAACGTTTCGTAAGTAC
X_nematophila_RAND_323	GCCTACCTGATCAGCCACTTGGATCTGCCCGGTTATACGCCAGCCCAAAAACGACTACTGGCGATTCTATTGAAAAATCA
X_nematophila_RAND_324	AATGATAACAGTGAAACAAGGCGTATATAAATCGTTTTTGGTTATTTTTTTTATCGTTATTTTAGGGCAGAATGCAGATTGAAATGTTTTT
X_nematophila_RAND_325	CTGATATTTGAGTTGTTGAAGTTTCGGCAAAGTGATCAGCTCGTCCATGCCTTGAGCGATCATAATTTCCTGCAAGGCCTGCACGGTACCGGAAGCACCAACACAAATTTGCCAGCCCTGTTCAAGCAAAATAGCGGTGACAGGGCTGAGAATATCATG
X_nematophila_RAND_326	ATAACATCCGGAAAAATTCCGTATTGTCTTCTTACGCTAAGCTACGCCCGGCCTTTGATCGTAAACATGGTACGGTGACAGCGGCAAATAGCACA
X_nematophila_RAND_327	AAATATTCATCATCCAGCTCTTCCAGTGCTTTGGCCTGATCTTCAATCACGGAATAAACGGCAGAATCTGCCGTGGTCAGATTTTTCTTAATCAGGCTAATAATTTCCTGCTCTAGCTC
X_nematophila_RAND_328	GCCGATATAAAATATAATATATGAATTTTGCCGATACAGTGGACAATCATACTCTACAAAAAACCACGGATTTAAGGTAA
X_nematophila_RAND_329	GAATTTGATCCACCAGCTCTCGCTGGTAAATACCGGGCATATAAGCCGGAGACCAGCGGCGAATACCGGGAATATGGCTATTTTCCGCAGGTTGTAATCCCGTGATATGTACTTTGCCTGACTGGGATTTCAGATAGCGGCTCACACCGGTGATTGTCCCCGTCGTTCCCATACAGGAAACAAAATGCGTAATTCTTCCCTGTGATTGCTGCCA
X_nematophila_RAND_330	ATTCTTTTAGCCTCTTCCCATTGCTTCTCGTATTCAACGGGAGAAATGCCCCCATTAAAACTATGGGGGCGAATGTA
X_nematophila_RAND_331	GTGCCTTGAAGAGGAACTGCCGCTTCTGATCGCTAGCGAGATTGTTTACC
X_nematophila_RAND_332	CAGAAGGCGCATCAGCCAATGAAAAACGGGCACAAAGATCAGTACGCGGAGCACCGGCGCGAACCATATTGGCCTCGCCACGATTGCCAAGGCATAAACCTAAGGCATCAATCGCGATAGATTTACCGGCTCCGGTTT
X_nematophila_RAND_333	TTCCAGTTCTTTGTACATATTAACGAGAGAAGGCGGAGCAGGAATGCCCGGTTGTACAGAGAAGGCTAACCCGTGAGCCTGGTTCGGGCCGTGATAAGGGTCTTGTCCCAAAATCACCACT
X_nematophila_RAND_334	CCATTTATCCGCCACAACAAGATGTTTTTAACGCATTTCGCTATACCGAATTGGCTGATGTAAAAGTGGTGATTTTGGGACAAGACCCTTATCACGGCCCGAACCAGGCTCACGGGTTAGCCTTCT
X_nematophila_RAND_335	TAATGCTATTTCTTCGGAACAATTTTACCAGTTTCACCCAATTCAAATCCCTCTGGTAATATCCCATTTTCATCTAATTTATGAAACAGGTCACGCATGT
X_nematophila_RAND_336	AAATTTACGAGTGGGACTCTCAACATGGTGAACTGGAAGGCTACCGCGCTAGTGATGGAAAACATTTAGGCTCGTTTGACCCGAAAACAGGCAGACAACTAAAATCAGCAGATCCAAAACGCAATA
X_nematophila_RAND_337	GAGAACCGTTCTATTAACCCTGTGACCGCATTATGGATCATAGCGATTCCATTGATGGACATGGTGGCCATTATGT
X_nematophila_RAND_338	GTAAAAATAGTATCACCGTCATTGGCGAACTGCCTTTCGCAACAGCTAAGCGAATTGCAGCAAGTGTGACGTTTACGGGAGAAAACTGATGGTTAAAGAATGGGCAACGGTTGTCCGTTGGCAAAAAGGTCGCGCGTT
X_nematophila_RAND_339	CTGTTGTTTTCAGCCCGACAAATAGAATTAAAACGCGTATGGTAAA
X_nematophila_RAND_340	CAATGGGTTGGTTATTGAAATGTTTATCATTCAGTAACAGATGCCGTTCTTCCGTTGCTTCTCCGATAACAGCATAAGGAGCACGTTCACGAC
X_nematophila_RAND_341	GAATCTTTGCCTACCGGAATAGTCAGCCCCAGTGCAGGACACAACTCTTCTCCCACCGCTTTCACCGCCGCATACAGACCCGCATCT
X_nematophila_RAND_342	GAGAAGATAGCCCGTGGATGCGTATTTTCCGCAATGCGCGTAAACAATTAGGTTAATTCATCTCTGTATTTTCTGCTGAAAAGGCCCTGAAAATTTATCAGGG
X_nematophila_RAND_343	AACATATATTCTGCGCGCTTCAGGGGATGTTTCAGCGTCTGATAGCCAGTGTTGATAGTTGTGGCTTGCTGAAGTGCCAGGGTTTTTTCACGTTCTGGCTGGTTGGCAAAACGAT
X_nematophila_RAND_344	GATCACCATCCATCTGGAAGGCAATGGAAAGTTAGGCGCAATCCAGCGCGCTGGACGAAAGATTGATGGGCA
X_nematophila_RAND_345	ATAAGCCGGACGGGTTGTTCTTCTGGTTGGCTGAGAGTAATTCGGCTTCCGCTGGGAACCTCTATTTCGGTAGCGGCGGACCCATTTGTCA
X_nematophila_RAND_346	TTGTGACGAGCACAATCCACAACCTGACGGATACGTTCCTCGTTACCAATATTACCGGGATTAATACGCAGGC
X_nematophila_RAND_347	AGTCAATACCTACCCTAATGACTCGGATTCTTAATTGTGGTTAATATTCAATCCGGGCCCAAAAAACAAACACAACATCTAACAAAAAATAGGGTATAACTATGACTAATAATCAATGTGAAAAATACAGCTTAATCCCTCCATTTGTTTTGGAGTACATATCTGATAATTGCGATGAATGTACTAATCAATATGTATTAAAGACATTAGGTCATGTTCATCACTTAATGGATACGTCTATCAAAGA
X_nematophila_RAND_348	ATACTCCTCATTTCTGATAAAAAAAGATTGGATATGATCTAAAACAGGAATATAAAAAAATTCTTATATTCCTGTCCTATACTCCCACCTAGCTTAAATCATCATTTTGAGTTCTTTGAAAATATATCAGAGTACTGACAAAAATGTTTATTATTTTTCATTGGCAATGTTTTGCTATAAAAAGTCAATACCTACCCTAATGACTCGGATTCTTAATTGTGGTTAATATTCAATCCGGGCCCAAAAAACAAACACAACATCTAACAAAAAATAGGGTATAACTATGACTAATAATCAATGTGAAAAATACAGCTTAATCCCTCCATTTGTTTTGGAGTAC
X_nematophila_RAND_349	CGATTTCGATAAGGATATCTGGCAGATACCTGCTGAGCGAATGAAAATGCGCCGCCCTCACATCGTCCCGCTATCCAATCAGGTTAAAGCCATTCTTATC
X_nematophila_RAND_350	CAGCAGAGTTGCCTGCCGTCTGGCTTGGCTCGGAGTGGCAATACCGG
X_nematophila_RAND_351	TTTAAATCTTTATGTACAGTGGTATATTCAATCTCATTTTCATGTAAACATAAAAAAACATCCTCATACTCACTATCTAGTAAGCATTTTATTTCTACAGCTTCATTCTCCAAAATGTATGGCATAGTATAATGATTTGAATCGAGCCTGTATAACTCGATACGCTCACCCATTCTTTCGCCAT
X_nematophila_RAND_352	ATTTCCAATATCTGATCCATTTTAAAACCTGCCAACTTATCACACAATAACATGTACCTTT
X_nematophila_RAND_353	CCGTATGTACGATTCATTGACTGATGAACAGCGCCAGAGATTTTTG
X_nematophila_RAND_354	GGGTGGGACATGGATATTTGGGTAACAGCACAAGAGTGTATCGGGCTACCGAATTTACCAACGGCCCCTTTTAACATCTCTAATCGTTTAAAAAAATTCGCAACTGACGACATGATCCGCAAGCG
X_nematophila_RAND_355	AGATTGACAAGAACCGTCGCAAAGGTGCGGACGGCAAAAAACGCCACGGCGACAGTGCGGGTGCGTACCTGATGTTTACCCGGGCCACCTATATGGATGGCCAGCTGATTGAATTTATTCCGCTG
X_nematophila_RAND_356	CCGCTTTGGCAACGGTAAACGCCCGGGCATGGACAGCCGCATCTGCCTCCTGCCAGTTCCAGGTGATGTCATAGCCCTTGGCACGGAAATAATCGACCGCCAGCCGGGGTTCCAGCTTGGCGGCGTAACCT
X_nematophila_RAND_357	TGACCGTCAATGAAACCACCCTGAAACCCGGTCTGGCGATGGCGGAATACCAGTCACTGCCGG
X_nematophila_RAND_358	GGGGTACCGTCCGGTTGCGCCCATTGCTGATAGTGGGTGGCATAGTCATCCAGTCCGGTGGGGTCAACCGGGTCGGGCAGCGGTTGCGGGGCATCAAAATAGAGACCGTAGACCGCTACCCCCGCCTGGCTTTGGGTATCACTCCATAAATTAGTAACCTGCGTCAGCGT
X_nematophila_RAND_359	TCACGACAGAGCGGGAAATTAATGTAACGTACATCAATCGCGAAAACAGACCTATTTATGTCAGCTGTACGGTAGTGCGTATTACCATCCAAGTAGATCACCCA
X_nematophila_RAND_360	TCTGTTTTGCTGGCTTACATTATTGCTGGGCTTTTTGTCTTTTTTATCATGCGTTCAATGGGGGAAATGCTGTTTATTGAACCTGTAACAGGTTCATTTGCGG
X_nematophila_RAND_361	CCCCTTAATACACTGAATCGTCAGGGGCAACGCTTGAAAAAAGTGTCGCCGTCCCGGCTTTCCATCAGGCCA
X_nematophila_RAND_362	ATAATGTGGTTCAGCACGTTAAACCGTTCCCGTACCAGCAGTTCGGTATCAGCAGCCAGACGCGAACCACAAAACATGTACAGGCTGC
X_nematophila_RAND_363	GGAAAATAACCGCCGACAGCTCTTTGGCGAACAGGCCACCCAGGTTGACGCTGTGCCAGTGCCGGAAA
X_nematophila_RAND_364	TCACAACGTCGTTGACCACAATAACCCATTGTCACTGCTCTGCACGCTTTAAATGGCGCGCCCGACAGGATTCGAACCTGAGACCTCTGCCTCCGGAGGGCAGCGCTCTATCCAGCTGA
X_nematophila_RAND_365	TCGCATTGGCTTGCGCTAAGTCCAGGTTCTTTTTGGCACGTTCTGCTGAAGCCAAACCGTCAGTAATCTCTTTCTGACGCTTTTCAATGGCCGCCATGATTGGTGGCCATACATACTTCATGCAGAACAAAACAAACAGGACAAACGCGAAGGCCTGGCCGAGGATTGTTGCGTTAATATTCACGGCACAATACCTCTATTTCAATTAATG
X_nematophila_RAND_366	ATGTCGCTAAGAGTTTTTTACAAATAAAATCGCTCATTCTGAACGGTTTCAGGAAATCAAAAAAATAATCAGACATAAGATGAGCACGGCTATGTCTATAGTAATTG
X_nematophila_RAND_367	AGTTTTCCATCGTGAACCTTGAACTTTCGGATCCTCCGGCCGAAAGCATCGTATTGGTAGTGCCAGCGCGAGCCGTCCGAGGTTTCACACTGCGTCAACTGATTCAGTACATCCCAGCGGTAACGCCACACTTGCGGCCGGAAGCCGTCACGTTGCTCTGTTTTTTCAATCAGCCGTCCATTGGTGTCATAGCGATAGCGAATATTACCGTGCTGCACCACCCGCCCGACT
X_nematophila_RAND_368	TCAAGCCAAACAGTCCCGAAAAATCCGCCGTTGAACGGTAGGTTCGGGTCAGTGACAAGGGCAGGGTGCCGGACAGGGAGAGCATCGGCCACTGTTGCAGAAAATCGCCCGTTGCCATATCGACCGGATCAC
X_nematophila_RAND_369	CCGCGTGACGACCTGAATCAGCCGTGGCAGGTGGTGAGCGCGAGTCACACTGGCAACCAGCCGGGCGCCCTGGAAACGGCCACCGGTGACAGCGGCACCACGTTGCACAGCCAGTTCAGCTTCATCCGCCATAACCAGCACTG
X_nematophila_RAND_370	ATTAAAAATACCTTTGTGGCCTTAAGTTTGTTTGCCGGAAACATTAATGTATGAAAGTGTTTACGAGGGGTTTTACATCAGTGTAATTTAGACCCGTTTGCCTTGTAGTTGAACTGACCTCT
X_nematophila_RAND_371	TAACTGGCAGCCCGTTATCTCATTGATTTTAATTGCCAGTAGCTCTGTACCTCAGCGTGAACGCTGATAGCCAAAGTCACCGGGAGAACGTTTTACAAGTTGTACCAGTAGCGTGCAAAT
X_nematophila_RAND_372	CTGACCACCATGTTGATGTTGCACCGAGGCAACATCGTCAGTGATGTCACCAGAACCCTCTGCTGCGCGCGTTCATCTCTGGGACGGTGGATTAACTGGTTTACGTTATAGGGTACTGAAGGTCTGATATCCCCGCGACTGGGTCATAAGCGGCGCTGGCCGTTTGAACAGATTTGCACGCTACTGGTACAACTTGT
X_nematophila_RAND_373	GCTAATTGTTGTAGAGGCGACCAACCCAGTAATGCCAGAAAACATAAATAAAATAGCGAGCTGATAGCTATTACCAGCGCCGGTTTTGCTCAGCCAGTAGGCATACATACCAAATACAATAAATACCGATAGGCCAA
X_nematophila_RAND_374	ACTTACTGCTATATGTTCTGTTTGGCCTATCGGTATTTATTGTATTTGGTATGTATGCCTACTGGCTGAGCAAAACCGGCGCTGGTAATAGC
X_nematophila_RAND_375	GTTTTCTTAGTTTTCTTTTTTCTTTATTTAAACGCAAAAAGAAGAAGCCAAATTCTATTTATCCATTACGCTAACAGGAGTGTGTATGTCGAAAATTATTTTTTTATGGGGGCCAGCCCGTTCATTATCCACCGCAATGTTGAAATCATTTCAAATGCGCAACGATACTACGGGGCTGTTTGAACCCTATGCCGATACCTATTACTTTTCCAAG
X_nematophila_RAND_376	TCACCAAAACTTTCTGACACCATGCAGTTACCAACTGGATAGTCAAAATACTTCATATTTAAGATAAAACTACCATCGTTATTTATCTT
X_nematophila_RAND_377	GTCGCAGATTATGGTGAATAAGCCCAGCGGCCACAGTCGCCTGAGTAAAGCGATCCACCAGAATAAAGCCGCCCAGAGTGGGGGATTGTTCATAGGCATCCAGTACCAGTGGGCGA
X_nematophila_RAND_378	GCCGCCGCCATTACAGAGGTAGTACAACGTCTGAAGGTCATTCACATTTTGGGGGACTGGCCGGCACCGGAGACGTTATCCGGCCAGTATGAGCGGGCTTTTTTTCCATTGACCGTCATGATTGTTGATGCGCAGGAC
X_nematophila_RAND_379	GTCCGATGACTGAGGACAGGATTCACCGCGCCTTGACCAACCAAATGGTTTAACTATCAGTTTGGTCACGC
X_nematophila_RAND_380	GGGTTTCTTTGGTTAACAGGCCATTAAAGTATGTCCAGGAAACTAATTTATTCAGATAGCGGTTATATTCCAGCGGTTGATGGCCAATAATCGCTTCTATTGTTGGAGTATGATTGTAAAGATACCAGCCGCTGCGGTTAACACGTCCCGGCGGGACATAAATGAAAGTCAAATCTTGTTCTGACAGATCCGGGGATATTTGAGGATTAACCAGTGTCACCTTACCAGGCAAAGCTTCAAAAGCGGCATACAATTTGCGGGTCAATACA
X_nematophila_RAND_381	ACAAACACAAACCACTCATCATCATTGAACAGTAATTCAACACGCTCATAACGAAAGCAGACCGCCCGCCAGATAACATTCATTGCGCATCCCCCGTCGGTTGCGCAGTCAAT
X_nematophila_RAND_382	CCCCCAGGGCTTTTTCAATAAAACTGAGTTCACCCCGCAGTTCATTTTCGGCCAGATGCCCGAGAACACACTGCAACCGGCCCGGCCACGGTTTAAACAGGCAG
X_nematophila_RAND_383	AAAAAGCTATCAGCAAAATCTGATAGTGAGGAATCTCAGGCCTCGTAAGATCAACCCACTGGTAGGATGTTTCTGCCAGTGTGTC
X_nematophila_RAND_384	ACCATTTAATCCGGTACGTCCGTTGCCACCGGTGGGGGGCAATCCTGCTATCCACGGTATTGAGCCACAGGAAGCCGATGTTTTTATGGATCTGCGCGAGCGGGTCGGGCACACGTTGGTGATGGGGACA
X_nematophila_RAND_385	GTTCAGGAAAACGTTCATGATTTTCCAACGCCGGTCCCAGAACTTCCACGTCGGCAGTGTTCACATCCTCAACCTGTATGACACAATGGGGATTGCCCATTGCCACCACACCGCAAAGCACCGTACGTTCAACAGCACGGATGATATAGGTTTTTTCAGCCTTATTGGCCCGAAAAGGAACACGCTGCGGTTCAAAATCTGGCTCGCCCATGTT
X_nematophila_RAND_386	GCGGTGGCTGCGCTCAATCAGGTCTGCGAGCGGCTGGTTTCATCACTGGCTTCTGCCGGTGTGATTGCCCGCCGGCAACATGGCGGGCAGATCCACCGCTGGTTGCTGCGTCATTTTAATCCGGTGCCGGACTGGGGGATGGCAAAAGCCGATTTTTACCGTACCGTGGGTTACGAAACCCCCACACCGTTCGATCTCCCGGTCAATAATGATTTTGCCGAAAGCCTGTGG
X_nematophila_RAND_387	TCAGCCACATCCTTGCCCCGCACCAGAAAGGTCAGCGCACT
X_nematophila_RAND_388	TGCCGGAGAAGGCGCGGTACCACAACTGGCCGTTGATAC
X_nematophila_RAND_389	ATAAAAGGTATATAAACAAAAAAACCGGAAAATCCTTGTGA
X_nematophila_RAND_390	TGGTTATTTGGTTCCACGCCTGACAAGGGAGATTGGTGGTGAACCAAGTAAGACACCGCTGGATTTAGGATTGAAACAAAGCTAGTGATATTTATCCTGCCTGCCAATCACTGATTCGCCAATACTCTCTTTCAAGAAACACTCTCTTTTAAGAGCTTTAGGAATGGGCAGCGCACAGAAACCA
X_nematophila_RAND_391	TACGCGCTTACCGGTTGTGATCCCAGAAAGAATCACGCTTGCACTGTGTAACCGTTTAGCACAGTCCCATTTGCAGGTGATCATGGTGACTCATATTAATCATGCAAATGAAATTGATAATGAGTTCCGGGGAAGTATGACGCGGCTGAAACAGGCTG
X_nematophila_RAND_392	GATTTTTGCCGTTTTTTTATCCCACAGTGGACACAATTTTGTCTCGATAATGGATACCGCCTTCGTCGCCGACAAGGTCATATGTATCCCAGTGAAATCATGAC
X_nematophila_RAND_393	CCCCATGCTAGAAGTATCCAGCCAGGTAACCATGCTTTGCAAAGCTTGAGGTGCATGCTGATAAACTTCAGGAATTACACGTTTCCCATTTCGAAGTTTACCGTCATAGAAAA
X_nematophila_RAND_394	AAAATGAATATTGAACCTCTGTGCAGGTAACAGAAAGTCAATTTCATGATAAGTAACTCTGTTATCC
X_nematophila_RAND_395	GCCACGGTACCCCCTGTCGGCAGGTAACGGATTTCCGGC
X_nematophila_RAND_396	AACACATTCGCATTAATGGTTCCGGCAA
X_nematophila_RAND_397	TGGTGACAGATAACTTCCTTGAACAGCTTCACGATTGGCGACCTGTTGTGCTGGCTGTCGATGAAGCACATTGTATTTCCCAATGGGGGCATGATTTCCGCCCGGAATACCGGGCATTAGGGCAACTTCGCCGCCGAT
X_nematophila_RAND_398	GGGATCAGACACCGGCGGGGTGAACCACAGGCTTTCGGCAAAGTCATTACTGACGGGGAGATCCGATTGTGCAGGGGCTTCATAACTGACGGTACGGT
X_nematophila_RAND_399	AACTCTGGTGATCTTACCGGGCCGCAGCGAAAGTTATGTGAAATACCCTGAAGTCGCCTACGATTTTTACCATCTGGGCTATGAC
X_nematophila_RAND_400	AATAGGTAACTGAGCAACAACCCGCTTTAAAATAATGTCAGAATAACCGGATTGTTCCGCCGGCTGAATATCAATGGTTATCTGTTGGGAAGGCAGGCGGTTTAACTGCTCCATGCCCTGTTCAATATCC
X_nematophila_RAND_401	GGCGGTTCTGTGTTTACGCTATTTTGCCTGATCTGCCAGCGTTGTCTGATCTTGCCAAATTGATCCATGATGTTGCTCCTTTCTTTTGTCAAAGAATAGACTCCGTTTG
X_nematophila_RAND_402	TGTGGGGCAGATCCGTGATGGATTAGGCATTGATGCGTATATGATCACGTCTAATGGGGCAAGAGTTCATAATACTCAGAATGAACTGGTATTCAGTCACAATTTAGATCCTGAGATAGCGCATGATTTGTGCTTACTAGAGTTTGATAATCCTGAGGTTC
X_nematophila_RAND_403	AAACTACAGAATGGAATAATGAGTAACGCCTGTAACATTTTAAATGTGCTCAGCGTCACTCATTATTTATCATTTTATT
X_nematophila_RAND_404	GATATGTGCTGCTTCCAATCCAACGGGAGTATCATCATGCCGCAGATTGTAACCACAGATTGCACATTCATAGTTATAAGCCCGCAATATTTGTTGGCGAAAATGCGGATCACGCATTTTGC
X_nematophila_RAND_405	CCAACAACCCGGCTCAGGTTGATAACGGCTATATTGAAAATGAAAATTAACCCGTGTCCCCATCATCTTTCAAGTGGCGGCGGTGAACATTTTT
X_nematophila_RAND_406	CGAGGTCTCCGTAGGTACGGAGATAAACCGTGGCCTGTGAAAGTGGATGCAGGAAAAACTAAGAGG
X_nematophila_RAND_407	TTTCAATATCATGCAGGTTGTCGCAACAGTTTCAGTCATAATCTTTAA
X_nematophila_RAND_408	ATTGAAATACCGAGACTCAGAATGGAATTGAATTCTTGTTTATTCACATACGGTAAATAAACAATTAA
X_nematophila_RAND_409	AAATACGTGAAGTTGAGTTGCGTCTTTCTGGCTTAAAAGATGTCATGCAAATTGATACAGAACGTACCACTTTG
X_nematophila_RAND_410	TTGGAACTCGCCTTGTTACAGCATTTGGAACTGACACCGGGCACG
X_nematophila_RAND_411	AGGCACGATCTTCTTCATCCATCCACGGCAACGGGTTATGTCCCCATTCTCCAGCCAGCCCATTCCCGCCCGCATGTACTCTGCCATTGAATGTAATCCCAGAACCACACCCCGTACCAATGATGACCGCA
X_nematophila_RAND_412	ATAATTTTTGACTTATGAGCACAAATAACACGATAAATTTAA
X_nematophila_RAND_413	GGCGCATAACATCCTGAATTTCCTGGCTCAAGGTATAAGCCGGCAAAGAGCAGGCGGAGTCACCGGAGTGAACACCGGCTTGTTCGATATGCTCCATGATACCGCCAATCAGA
X_nematophila_RAND_414	ATTCTGAGCTTCTTTTGAGTATGAGCAAATGACACTATGAAACTGAAAAAATTCTTAATGACAACTGCCATAGCATTAACTGGTTTGATGTCAGTTCATCAGGCAATGGCCGCAATAACGTTGGATCGTACTCGAGTCATTTTTAATGGTGATGTGAAATCTGTCAGCCTTAACA
X_nematophila_RAND_415	AATGTCTCTTCATGGCAGGCAATCTGGAAAACAGAATCCGCGGAAGTATAGAAAATCGGTTTGCCGGTTTTAATA
X_nematophila_RAND_416	ATGGATGCAGCAACCAGTGCCATGATCGCCACAAATGACTCCATTAACATCGCACCATAACCGATGAAACGGGCATCTTTTTCATTTGCCAGCAATTTAGGCGTTGTTCCCGAAGAA
X_nematophila_RAND_417	GATTATTGTTGCTTCTGTCGCGGTTTATTTAGTTGCTTATCGGTACTACAGCCTTTATATCGCAACGCGGGTCATGAAGCTGGATGCTACG
X_nematophila_RAND_418	TCATTATCAACAGCAAGATTATTATCAGGTGCTGAGAGAATGTGATCACACTAGCGACTGCACACCCTTTATCAACTTCATGCTGAAAAAATTAGCCGAAGCACTTAGAGAAGGTCTTGA
X_nematophila_RAND_419	TAGTCTGTCGATTTATTTTGAGCGTGATTTTTAAAATTGACTGTCATTTTGTCTGAAATTAAGCAAAATACCTCGCTTTAAATCTTTTGTGATTCTAAATTTCTTTATAAATCATCATTATTATTAGTGCTTATATTTGCCTTTGTGGGGGAATAAGGTATGAATTTAGGAAACCCAATGAAAA
X_nematophila_RAND_420	TGGGAGCATCAATACGCTATGGACATTTCAATTCTGTATTGCA
X_nematophila_RAND_421	TTCGCAGTTTTTTGATTGATGCGGGAGCAGAATATAATGGTTATGCTGCGGATATCACCAGAACCTATGCGGCGAAACCTAATAACGATTTTGCCTCATTGATTAAAGATCTGAATGACGAGCAGCAGGCGATTATCAGCACAATTAAAGCAGGTGTTCGATATACTGACTGCCATATTAATATGCATCATCGCATCGCCAATTTACTGAAAAAGCACGGCATTATTCATGGGATCAGTGAAGAGAGCATCGTTGAAAAAGGGCTGACA
X_nematophila_RAND_422	ACGATCGCGGGAAAGCTGCAAGCGGGTAGGAGAGGTATTTTGACGGAGCGAATAAATAACCGACTTATGATAATTCAGGTCT
X_nematophila_RAND_423	AAGTCATTCGGGGTAAACGAACGACTATTACTGAGCCACTGTTTCCCAATTATCTTTTTGTCCATTTTGATCCTGAAGTCATTCATACCACGACAGTTAACTCAACACGTGGCGTCAATAACTTC
X_nematophila_RAND_424	ATTCACTGTTCACGGGCAGGATGGTGTTATTGATCAGGATGGCTACGTTATCAATGA
X_nematophila_RAND_425	GAAAGACGCTCAAAAACTTTGCCTTTCACTTTGCCCAGCCATAAATAGGTCACAGGTCCCAACAGAACAGGTTTTATTTTATGTCCCAATGCCAGAGCTTCATCAA
X_nematophila_RAND_426	TAGGCCTCGACTTTATTATTTGGAAAACTAACAAGTTGCAGATAATTGTTGCCATAGTCGTGGCGATTTCTCACATCACTATTTTTCACATCAATATTTTCTACACAAGCGATAGTGAAATAACCGGCATTGCCACAACCACCATATAA
X_nematophila_RAND_427	ATCAATTTGAATGTCGGTTGTCCTTCTGATCGGGTGCAAAATGGTCGTTTTGGCGCTTGTC
X_nematophila_RAND_428	CTCTTCATTCTGTCAGCGTTGGGAAGAGCATAGATTA
X_nematophila_RAND_429	TTCTTTTTATTTTTTTCAGCAGTATGGTTGTGCTGGCATGTATCGTGTTCTGTACAAGAATTGATTTCATGACAGGAAAAACATAACCCGTGCACT
X_nematophila_RAND_430	CGGAGACGGGCACCATCTGAATATTCAAATCGGGGTTGTTGCGATGCAAGTCCAGATAGAAATGAAAAATCTTTACAGATTCGTGTTTTGGTGCATAGCAACGGAACACACGT
X_nematophila_RAND_431	ATCAAATGAGCAAGATCTATTGCCACATTAGCCCCCTTATTGACACGTAAAAGGGAATTCCGTCTGGAATCCCCCCCGATCATATCTATGGGTATAGTCAATTTAGAATTGCTGTTCTTCC
X_nematophila_RAND_432	TGTAGGTGTGTTGTATCGAATGGTCATGTTACCCTCACGGTTTAGTTGTTTTTGTGAGGGTATTTTCTATAGTTTTTAGTTGATTGGCATTATAAGAAAAAAAATTTTTTATTCTA
X_nematophila_RAND_433	ACATACCAGAAATATCACCCCGTTCAACCAGCGTTAATACATCGCGCCCCAATTGGGTATCAGGC
X_nematophila_RAND_434	ATCAATAAGTTAAGAAAAGACTATGATCTGGGATGATAAATAA
X_nematophila_RAND_435	TTCGCCCTTGTTGACGTCATGACAAAGATATTTTCATTGCGAAGCAGGTTTACCGCAGGTAATTCATCTGGTACA
X_nematophila_RAND_436	GGGTGGTGCTGTTGGTGCAGGGGGTCTGGGTCAGATTGGCTATCAATATGGTTATATCGGATACGATGCTGTTGTGATGAATACCGTGTTAGCTTTACTTGTTATTTTAGTATTCCTGATTCAGCT
X_nematophila_RAND_437	AACCCGTAGTTATCCATTTAATAACCTAGTTATAGTCAATCGGCTGTGAATAACTCTGCATTTAGATCCCAGCTTATACTG
X_nematophila_RAND_438	TGGTTTGATCCTGCTGTCTGGCGGACGCATGGGAGATGTCGGGAAATTCCTGCTGCGTGGAAATCGTGCGATGGTGGAGCAGTGTCTTGATTTTTACCAAGAACA
X_nematophila_RAND_439	TCCATGCCACAATGCTTGCCATGCAGCGGGCTGTTGCGGGTTTGGTCATCGTGCCTGACTACGTTCTGATTGATGGTAACCGTTGCCCGGCATTAGCAATGCCTTCACAAGCCGTGGTGAAAGGGGATAGTTTGGTTGCCGAAATCAGTGCAGC
X_nematophila_RAND_440	CTTTTGGACCGATGTTATTCGAACGGAAACCACGCACACTGTTGGAACCACCGGCATAGAAGTTTTCATAGAATGGCATTTCTTTGCCGCCAAAGCCGC
X_nematophila_RAND_441	GGATGATGACCACTCATGGGTATTGGCAGGACGTTCACGTCTGGGCTATGGC
X_nematophila_RAND_442	CGGATTCGTGGTTCGGGACATTCATTTCGAGGGTCTCCAACGTGTCACCGTTGGTGCAGCATTACTGAACATGCCAATTCGCGTAGGTGATCCCGTCAGCGATGAAGATATCAGTC
X_nematophila_RAND_443	CAGTGACTCAATATTATGTTTAACTGAAAAACTTACGGTGTTCCGCACGGCTTTAATGCCTGCCCGGTGGCCAAAAACTCTTAATTTGCCACGT
X_nematophila_RAND_444	AGATCAGTGAAGACGAAGAACGTCGTTCACAAGATGAAATTCAAAAACTGACTGACAGCTTTATTAAGAAAGTTGATGAAGCGTTGGCAAATAAAGAAACAGAGTTGATGGATTTCTAATCTCCATTTCTTAAATACAACGCCGCACCCTGCGGCGTTGTTCTTAT
X_nematophila_RAND_445	GAAAATCATTTTCTCAGAAAGAAAATCGTACCAGCAGATTCAGTCTCTG
X_nematophila_RAND_446	ACAGGCAGGAGAGCCAAAAGCTATCAGTATAATGATGAAGTAAGGATAACAGGCAGGGACGTATTTTTGTCAGGGAATGAGCA
X_nematophila_RAND_447	TGTTCTGCCAGAATTAGCCACGGTAATAAGTTGGCGTGGT
X_nematophila_RAND_448	CATCAGCGGGAACGTTTCTGCATAGTATCCTGGAGGATATCGATTTTGGCCATCCTCCCAATCAGGCGTGGTTATCGGAAAAGCTGATTACATCAGGGTTTGATGAAAATTGGGCGCCAATATTGGAGCAATGGGTAGACGATATTCTGC
X_nematophila_RAND_449	CGCAATCTTTGCTGATGACACCCCATACTTTTCCTCGTG
X_nematophila_RAND_450	GCTGATTGAGGCTTCAGCCGGTACAGGAAAGACTTACACGATAGGTTTGCTTTATCTCCGCCTGTTACTGGGATTGGGCGGCTCTGCCGCCTTTTCCCGGCCGCTGAATGTTGAAGAGATTCTGGTGGTGACTTTTACAACCGCGGCAACTGATGAATTGCGTGGGCGTATTCGTG
X_nematophila_RAND_451	AACGATGAAGTTTGTCGTTTCTGCCCATGGAGGCCGCTGTCCGA
X_nematophila_RAND_452	TGGTGTCGTGACTCGGCTGGGTAAATTCAGTCATGTCGTTCAACCCGGT
X_nematophila_RAND_453	CAAGCGTTGTCATCTTCGCTCCATCATCCATGAACTGCTTTGGTTCCTGAATGGTGATACCAATATCAAGTACTTGCATGATA
X_nematophila_RAND_454	TGCGGAGTAATGGTGGCCTCGTGGGGCGGTGCGTTCTTCCCCCCATAGGGCAGCAGGAATTGGATGCCCTCTTTATTGGAAAAGCTGGCATTCGGGAGCAAGAAACCGGAGCGGCGTTTATCACCGATCGGCAACTGCAAGTATGGGCTGTA
X_nematophila_RAND_455	TCAACGCCATTAACAATCAGCGTATCCCCTAAAAAACCCTGATTAGCCGGAGGGTCATATTGTGGTACGCCAAAGTTATCTAATCGCTTATCCTGCAAAATGACAGGAAAATCATCGACGCCATAATG
X_nematophila_RAND_456	GAGTGGCAATTTCGTTGGTTGACTTTTGTTGGCTTGAACCGCAAAAGGGAGTGCCCCTAAACACATTGCCAAACC
X_nematophila_RAND_457	TGTAAAGCAGGTCAGAAACGTCAACTACCATGCCAGTCAGGATATCTGCAACAGCCAGAATGTCATCCAGCGTTTGCTGATAATCAACGGCAGGTTCTTTGTAGTAGTTAACTAATTG
X_nematophila_RAND_458	TCTGCTAGAATCAGTGGTATTGGTTTTTATGCAGAGGCAACTTAAGCAAAATAGCTGCACAACAAGGAACGCAAATGAAGAAATTG
X_nematophila_RAND_459	TGCAAACGGATCATGCCGGCCAGTGCGATCATCGCTCCATTGTCAGTGCAAAATTCAGGACGGGCATAAAAAACTTCGCCTCCCAGCTTTTCCATAAGCGCCTGCATCTTAGTACGCAATGTACCATTTGCACTCACTC
X_nematophila_RAND_460	CGGGAATTGGTGAGTATCAATTGTTGGGTGAATCCATTGACGATGCCGCAGGTGAGGCTTTCGATAAGACGGCGAAACTGCTCGGATTGGATTATCCCGGTGGTCCGGTACTTTCCCGCATGGCACAGCAGGGTAAAACGGGCCGTTTTGTTTTCCCTCGCCCAATGA
X_nematophila_RAND_461	TGTTTACTGGATTACGTAAGTCAGAGATTTTTAACCTTACTTGGGA
X_nematophila_RAND_462	GGTAGTAACGCACAGGCCGATTTATGGGCGAGGTCATTAAGGGCTATTTATCGTTTTGCGCATGACCATTACCGAGATGAAGAAGAAAGGGTTTTACTTCCTGATCCACCTACCGCAGTGTTGAGCACAAAGCGTAAATGGCATGGCACGGTAAGAAAAACGGAGCGTATTCGAACACATGAACTTGTACGCTGGTTAGGTGCGGTAGCTGCTGTTCGGGAGAAAGCCGAAAATGAAAGGGATGATG
X_nematophila_RAND_463	TTTACCGAATATCGCCGCCGATGCGATCCACAATACCGCCACGCAACTGACACTATCGCACTGGCCAGCGAACCGGACTCCTGAACGCTACAAAGCGAACCTGTCAA
X_nematophila_RAND_464	ATTAGATCTCTCCATTATTAATAGAATACTGGATAAAAATGCGTATTTACTGGCAACCCTCCTGGGTAAAAATGAATCATTCAGAGTTTATATTGATTCATTGGATAATCTAAATAAAGAAGGTGAGCTGTCTATATA
X_nematophila_RAND_465	TGTAATAACATCGCACTAAAACATATCAATAATAGAGAAAATAACCGCATGATTGGGCTCCTTATTCATCCTGATGAGGAAATAACGTGTTGTCGATGAGGTCGCACAGGCAATTGATCGTCAACATATGAACTTCCTGAACTCTGACACTGTGATGTGAAGGGATTCGA
X_nematophila_RAND_466	TCGTCCATGCCGGCATCAAGATATTCTTTTTTATCCTTCAAT
X_nematophila_RAND_467	TTCCCCGCAGTCCAATGGGCTAAAAGGAATATTGGATAAGCTGTTTGGCCGAACATCTGTACAGTACCGGCCTGTTCAGGGGCTTTACATG
X_nematophila_RAND_468	TTGAGGCTAATTCTGTTGGTAAGGAAGTGATTTGATGTATAT
X_nematophila_RAND_469	GAAGGTTTCCGCCTTTAATGCTGATTTTTCTGGCAGGCGTCATTTAAGGGATCATTCAAGCTAGATTAAGGAGTACGTGGTAACGTTATGAAGCAAAGTTTACAACTTAGGCTCAGCCAACAACTGACAATGACGCCCCAGCTCCAGCAAGCAATACGTTTGTTGCAACTTTCCACGCTTGAACTTCAGCAGGAAAT
X_nematophila_RAND_470	AGGATCGGCCACTTTTTTCACGTCTAATCTGAAATTGATCGCGCTGATAATGCCATCCCCGAATTTTTCATGAACCAGTGCTTTTAATGTTG
X_nematophila_RAND_471	AATACTCCGCACAACAATGTCATTATCAGAGCCGGGATAACCTTATGATTACAGAGCACTTACGACTG
X_nematophila_RAND_472	CGATGATTCTTGTCACCAGCAGTTGATCGATTTTGTAATTATCGAT
X_nematophila_RAND_473	AATGACTAATGGAATTCTGGTCGGTGGTGATAATTCTAAAATGACTATTTTAGAGAAAATGGCACGATTAGCTTTGGAA
X_nematophila_RAND_474	AAAATGCGGTCGGCTTTGAAATATTTGATCGTAGCGCGAGTCCATTACAACTTTCGTTACAAGGTCGAGGTTTTATTGTCTACGCCAGAAATCTGCTGGGAGATATAGAATATCAAATCGGAAAAATAAAAGGCGGTAAAACTTCTAAGCATCGTATTAATATCGCCGCAGCACATTCACTTTCTATATCTCTGTTACCTG
X_nematophila_RAND_475	TTTTTTTCCAGCAGTTGATTAACCTGACGTCCCATATAGCTTTCATCAGTGTATTTCATCAACGGCAAAGGTGTCTCTTCCAGACGATATAGCGGTTTTCCGTCAGAGCTACAACCAG
X_nematophila_RAND_476	TTAAAAGGGATAAGTTACTTTTATCCTTTTGGAGGGATACTTATGAAGATCACATCACCACAAACACTGGCTGTAGC
X_nematophila_RAND_477	TTAATGTTACATGAAGGCAAGACCGTTTCTGCCCTCTCCAGAACCCTTCATTGTTCACGTTCTTCGGTTAA
X_nematophila_RAND_478	AGCAGAAACGATAATAACACTTACTCTGATAGTTCCATATACGTTATTTATTATGTCCGTGGGGTTAAGATACAAGGCCTTTTTATTGATGAAGTCACTGATTCCAATATAACCTGAATAATATATTTTCTT
X_nematophila_RAND_479	TCAACTTTTAAACGTAAATTAGCACTATAAGCCGATGGAGTTGCAATAGAGACAAAAAGCGCACATATGAGAGGATATCGTGACACCCGGACTCCTAATATTTATCTATCTGTAGGATAACAATATAAAA
X_nematophila_RAND_480	TCCGTGAGGCGATCATAAATGCCGAAAAGGAAATGATGTATAGAGT
X_nematophila_RAND_481	TCGAAAGAAATAACGTCAGGGCGGCTTATATTCACACGTCTAAACATTTGGATGAACGGCGGCTAATGGTGCAGTGGTGGGCTGATTACTTGGATGCAAATAGGGAAAAACATATAACACCCTATGATTTTGCGAAAACCTCTTAATTTAACAAAAAATGGATAGCAAAATCAGCAAACAATTTTATTTTTTGGGAAAAGAATTAAACCTA
X_nematophila_RAND_482	AAAAATAAAATTGTTTGCTGATTTTGCTATCCATTTTTTGTTAAATTAAGAGGTTTTCGCAAAATCATAGGGTGTTAT
X_nematophila_RAND_483	GCCTGCGGCGCCGGTGTGTACTGCTGAATGGATATTTAC
X_nematophila_RAND_484	AATCACGGCGCTCGTCATAGTGGATAAAGAGACATCCCGCAATGTGCGCGGGTGTCCGCAAGGTTCAATTCTGTCACCGGTATTGGCCAATATCTACCTGCATCATGTAATAGATGAATG
X_nematophila_RAND_485	TGGGCGATATCATCAGGGAATGGGGTCTCCATTCCCTCACTTTACAGCAAGTTATATCCGTAGACCAGATCGTTCCATCCGCTGCGGATGTTTCCAGTTTATGCCTTCAAGCAGCATGGACAGTTGGGCGGGAGTCAGATGAACTTTACCCTCACGGGTCACCGGCCAGACGAAGCGTCCACGCTCAAGCCGTTTGGTAAACAGGCACAACCCATCGGCATCAGCCCACAGTACCTTAAGCATATCCCCCCGGCGACCACGGAAGATGAAGACCTGCCCGGAGAACGGATTATCTTTCAGTGCGTTTTGCACCTTTGAGGCCAGACCGTTGAACCCGTTG
X_nematophila_RAND_486	GCAACACGGATTTCGTTTTTTATTGCCGGATTCAGTATTGCGAGTTGGGCACCTTTAATCCCCTTGGTGAAGGAACGTCTGGGGTTGAGCGATG
X_nematophila_RAND_487	TCAGGTGGTTGATTTAGAAGGTCGCCGTAATTTATCGGGGA
X_nematophila_RAND_488	ATGAGCAAATCACCGGATGTGATATCTTCTAATCCCGCAATCATTCTAAGTAGTGT
X_nematophila_RAND_489	ATAAGTTTTCAAATCTGACAAAAGACGACTTGTTATCTCAACAGTTCGAGTTTTATTGTATTTTGTAGGTACACCATTACTTGGCCCTATTGTT
X_nematophila_RAND_490	GTAGGGCTGCCGCTGGTCGTACATCGCTGTTGTGACAAGC
X_nematophila_RAND_491	GCGTTTGCCGTGAAACGCCTTCCTGATACATCCGTATCACGAGTTGTCGGTTATATTGCTGTATCTCAGGTGAGAGTTGTC
X_nematophila_RAND_492	TTGATAGATTGATGTTCATGTTCTGAACCGATATACACCTGCGCTGCCACAGCACAAACATTGAGTC
X_nematophila_RAND_493	TGCCATTTATGCCAGACTTGATGACATTGCGACATTGAGTTTCCGTGGTGCTAAAACGCTGGGCGGAAAAATGGAGCAGCATAAAGAAGTGGCTTATCTTTCCTATCAGCTTGCGACGATTAAAACTGACGTTGAGTTGGATAAACACTGTATCGAGCTTTCCGTTGTACCACCCGATGC
X_nematophila_RAND_494	TTCTTGCCCCTCTTCAAACAATCCAAGTTCACCAATGAAATCTCCCTGATTTAAGTAAGAGAGGATCATTTCTTT
X_nematophila_RAND_495	CACGCTTATTCATCAAGGCGAGAAAGCAGAAACGCTTTACTATATCGTTAAAGGTTCAGTTGCTGTTCTAATAAAAGA
X_nematophila_RAND_496	AAATCATGCCATCTGACCTCGATATGATTCTGACTTCTGCAATGACCCTGATTATCATGGGCGCCGTTGCTTTTGTCATCATTATGCCCATCGGAAGTTATTTATTTACCGCAATGTCATGGCTGTTCATCAATT
X_nematophila_RAND_497	CTTACTTCTCAATGCTTCCAGTGTCGCTAAAATAGCGGT
X_nematophila_RAND_498	CGCATGGAGCTTATCGCTCCGGCCCATGTCGATAATCCTTTTCATTTCAGTTTCCGCCGGCCGGATAACCTGCCCAATCCACTCTTGAACATGGAAAAAATCAGTGCTGGCTATGGTGACAAAACCGTACTGGATTCGATCAAATTAAACCTAGTCCCGGGTTCGCGCATAGGAT
X_nematophila_RAND_499	AAATGCGATCCGGCATGGTGTAGAGACTAAGGTTTCCGCCCGTGTGAGTGATGTATTCTCCGCGCTCGAAATGACTGAAGACTTCGACTTAATTTTCTGGAACGTTCCA
X_nematophila_RAND_500	GCATTGACTAAACGTATCCAAAATGCGGGTACTGAAGTGGTTGAAGCAAAAGCGGGTGGCGGATCTGC
X_nematophila_RAND_501	CTTATTCCGATAGTATTCAACCGTGTTTTCACTGACAGTCAGCACATTGAAAACGTCTTCAGGAAAACTGTTGACATTATATTCGAGAGCTTTTCCCTGCACTCCACGCTTACGGCGTTGTTCCCAGCCCTCGCGTCTTGCCATTAGATTCACGCCTTGGGGAGACGATGGCAGCCCTGCAAGGCCGATGAGTTCCTTTGCAGAATACCATTCTTTTTTCATCTCTTTCTCCTCACTTCGTACCGGGGTAGTGAAGAAAAAGCCAAATTTTAAACATTTGGCTTTTTCAAAATCAGCCTCAGGTAGCAGTAATTTTTTCCAAAAAACTTCTTATGCCATCTCTTAATATCACTTCAGTAATTACCTCCTTTTCTTCTTCAGTGAGTAAATTAAATGCACTTACCCAAATGGATAAAGGATCTTGTTTCTGAACCTGATA
X_nematophila_RAND_502	CCGATTGACTGTGCCGCGATCACACCAACTGCTTCACCTTTGTTGATGCGATGACCACGAGCAAGGTCGCGGCCGTAGCAGTTCGCACAGACG
X_nematophila_RAND_503	CTTCGACCGCAGTGGCAATCATGTCAGGCGTCATGGCGAGATACCGG
X_nematophila_RAND_504	AGCGCCAGAGCGGCGAAGGCAATCCGGCAGACGGTACGGGGTTGGG
X_nematophila_RAND_505	TTGAGTCCTTCTAATCCATATAACCTAAACCCTTTAACCCAGCGATTGACAGAAGAGCGGGCGGCATGAAGGATTTTA
X_nematophila_RAND_506	ATTAGAAGGACTCAACAGTTTACCCGCGGGTAGGCCAGCAGTCTGGGA
X_nematophila_RAND_507	ATTTAGTGAATTGCGATAATGCAGTTGCACTATTATGGTGCGTTCGGGGGAGCATTTGGCTTCTTAAAATAAAGGCAGGAATATCAATTCAATATGTCATTCGATCTATTGAGATG
X_nematophila_RAND_508	AGGTGCTACTGAATATCACCCGCAATGCGCTACAGGCCTTGGATAAAAGAGGGGGAACCATGACTCTGAGAACACGAACCGAGTTCCAGATTACCTTACAAG
X_nematophila_RAND_509	GATCAGCACCAATACACCGAAAACAGCCAGTCCCCGTAATGTCCCTGTCAGGGATTTCTGAGGGTATACCGTTATTGAACCGACCA
X_nematophila_RAND_510	TTCAATAACGGTATACCCTCAGAAATCCCTGACAGGGACATTACGGGGACTGGCTGTTTTCGGTGTATTGGTGC
X_nematophila_RAND_511	TCCGCCGCTTCCATACACAATGGTGCGCTCCCTGGGTGTTCATTTACTCTTTTTTCAAATCCA
X_nematophila_RAND_512	TTGATTTTACCCATTCCCATCGCGTCTTTTATTGCCGGGCCTTTGGCTGGCATTGCAATACCGAAATTAGGTTCCAACAAAATTATGTGGCTCGCACTTGCGCTTACCGGGCTTGGCACCTTTGGCTATCTCATTGGGCTGCAATCCGGTCTGTTTATGCAAATTGCGGCATTCAGCATTATCGGGTTTGGTGCTGGTGCAGCAATGACCGCCGCTTCCACCGCTATCATGCTCAATGCGCCGGAAGACAATGCGGGCACGGCCGCTTCTATCGAAGAAACTGCATACGAACTGGGAAGCTTAATCGGGATAGCGGTTCTCGGCAGTCT
X_nematophila_RAND_513	CTCAATGTATTCAGTGCATTGAGGGTTTTTAAAGCGGAGATATTGCCTCTGT
X_nematophila_RAND_514	CTGTTTCAAGTTCAATGACCGCTTCAAGCAGCTCATTCAAATCACAACATGTCAGTGGCATATTCTGCCCCGCCCGCTGGTAATCAATAAATTGATCAATAATGGCGTTGCACTCTTCAATGTCCCGGTG
X_nematophila_RAND_515	TGGCTGGGAAAGCGCTTTAAAGCCTTCACTGGCTTTCAGTGACTTATAGGCTTGATATAACGCTTTGTGCTGCCCCATCCAAGTATTAAATTCAGAAAGCAGGGGCAGGCTTTGCTCAT
X_nematophila_RAND_516	GATGAGTTAGAAGCCTGGGATCTGGCCTATTACAGCGAGAAGCAAAAACAGCACGATTTCTCCATCAATGATGAAGAGCTGCGCCCTTACTTCC
X_nematophila_RAND_517	CTTGGCGCATGTAATACGGGAGGGGGTGGCGCTCTGGCGATGG
X_nematophila_RAND_518	GCTACCTGTTAGTAAATTTATATGGTTTAATGCTTTCGATCGAAAAAGATTAGCTTTTGATTACACAACAAATATTCAAAAAAATGAAGATTAATAGCTTCACAAAACGTTTT
X_nematophila_RAND_519	AAGGTGAGCTGGATCTCGACGGACTAAAGGGTATAAATAAAAATGCCAA
X_nematophila_RAND_520	ATCAAAAGTACGATGTATCAATACTCAGGATGAAGAAAAAGTATAA
X_nematophila_RAND_521	TTTGAAATACAATCTGGATTTTCTGGCGACGCAGTTTTTCCGCTTCTTTATTGGGTACTAATAGATCTTGCCCCAAATAGTACAGTTCTCCATCGGTCGGCTTTTCAATCATCGTCAGCAGACGACCCAACGTGGATTTTCCACAGCCGGATTCCCCCACAACTGCCAGCGTTTTACCTTTTTCCAGTTCAAATGAAACCCCATCCAATGCCTTAACCATA
X_nematophila_RAND_522	TGGCAAAGTAATAAGGAATTCAAACCCACGCGTGATTTCAATGCTGATGACATTATCTTTACCTTTATGCGTCAAAAGGA
X_nematophila_RAND_523	AATTCATTATTGATGTTGTTCTACGGTCCAGTGACCTCAGTATGCTGAATTTCATTGTCATTGGAATCGTTCTTCTGCTCTCCCTG
X_nematophila_RAND_524	ATGGATTATGAAACCTCTGCTTGCTGTTGATTTACCGTTTTCTGCCTTTCTGGATACACTTCTGCTCCCTTATGATTATGCCCGTTCAAGTCAAAATCAAGCTGAACAATCCCCCAAGCGTCGCATTGAACAACTGGAAAAAACCAATAACACACTGC
X_nematophila_RAND_525	ACTCAGCCCGTTTACTACCAATACCGGGTA
X_nematophila_RAND_526	TTCTTCCTGTCCGGCCGATGGTGAAATTGACATCTTTTACCGTTGTCACCTGTTGGCGTAACGGAT
X_nematophila_RAND_527	GCCAGATGGCATGGATTTGGTGGATGCCAATTGCATCCGCCG
X_nematophila_RAND_528	GGTATATAGTGTGTTTCAACTTCAGGATTAAGATAAAGGCTG
X_nematophila_RAND_529	ACAAACGGTTTCAGGCTCTGCTGGTAGAAGGTATCCAGCGTGCCGTCTGGCCGGAAGAAGCGTTCAAACTCGCTCAGCGGCACTTCTTCGGTCGCGTTGGGGTTGAACGGATAACGTCCC
X_nematophila_RAND_530	TCCTGTTCCATCGCCTTCCGCCATGAAG
X_nematophila_RAND_531	TTTACAGTCGATGGTACGCCCTTCTCCATCCGCCAGTTCCCCTTTATCGAAAGCCTGATAGAACAGGTTCAAGACATCCGGGTGCGCTTTTTCGACTTCGTCCAGCAAGACGACGGAATAGGGTTTCTGACGAATAGCTTCAGTCAGCACACCGCCTT
X_nematophila_RAND_532	AACCAAGAAAGTAGGGCAGGTTATCTGGGACCCTTCCACTCCGGTAGGTCACCCGAATGATCAAGCCTCTGTTGCCAATATTACATTGCTGGCCGAACCC
X_nematophila_RAND_533	GTTTCTGCGATGAGCGTTTAGACTGCCGGTTGTGAATACTGGGAAAATCGTAGGTACGCAGTACCTGTTTCAGCGCATCCTTATCCAGTAATGACATATAGTTCAGCGACATATTTGACAGCAATGACC
X_nematophila_RAND_534	AAGTCATGGCACGATGGCTCAACCCCATGTTACGAGGCTGGGTTAAGTACTATGGGCGCTTTTATCGGTCAGCAATGGACTGTGTAGCCAGTCATGTAGATCTGCACCTTGCTAAATAGGTTACCCGCAAATATAAGCGGGTACACGGTAGTCTGGTTCAGGCGTATGAATGGTTAGGCAGGATACGGAGCGTTAAGCCCGGTCTGTTTGCACACTGGG
X_nematophila_RAND_535	ACGAACAGGCTCTCGATCATCTACATTACCCGGTGTCACTTTAAGCGCCAGAATTTCCCCCAAATGGTTCACAATCAAGTGTAATTTGAAACCATAAAACCCGCCCATTGATGTTTTTCCTCGTGCGGCGACCCCTTCAAATACTTTATGACGGGGAATACGAATGTTATGACACACGCGCA
X_nematophila_RAND_536	GAGTGCGGAAAAAGGGACTCCTGTGGCTGCGTTACTGTCAGCAAGGCGGTGTGAGTTCAATTGATGGATGCAACACACTGGTTAAATCTCTCTGCGGGTGATTCATCGTCTAACGTTTTTCTCGGCCTCTCATTAAGTTGTCGGGCAACACTGTCTAA
X_nematophila_RAND_537	GGTATGTTGCCAATTTGCCTTGGTGAGGCGACCAAATTTTCCCAATTCTTGCTGGATTCTGACAAACGTTATCGTGTGATTGCTCGTTTGGGGCAGCGCACAGACACTTCTGATTCACATGGACAGATCATTAGTGAACGTGAAGTGCAGATCACCCAATCCCAGCTTGATACTGC
X_nematophila_RAND_538	GTTGACGAAATTAACCATGGCACCGTCTTATTTTTCCAGCAAGATGAATATCGTGATTGCTTATGATCTTTATCAGGAACGTCTGGAAGGGGATGAACCAGAACCATTGGTGCAGAAACGCTGGCCTGTCTCCGACATGATGTCACTGCTGGAACAGCCTGATTTCAACGAAGCCCGCAATGTCAGCGCCCTATTTTTTGCCCAGCGATATCTGCAAGCACAAAATAATGGGAAATCCTGATCAGATGATTGTCTAAAAATGGGTATGACAAAATACGCTCTCAATACCCATTTTTCTATTGCAAACAAAAAACCGGAAATAAAAAAATAATTGATACTTTAATAAAATAGTGTTAATCAATTTCTACCTAAAATCAGCTTTCATTGCATACAAATGAA
X_nematophila_RAND_539	CTAGACCAAAATACCGATATAGATATGTATGTCGATTGCCATGTTGTTAGGCAGGGCCGTCATCTTTCCTTGCATGAAGAAGAGAAACACTATCCTTATC
X_nematophila_RAND_540	CTTTTATTGATTCTACCAAAATTGCTGTTTGTCACAATCTTCGTATTCCCCGTCATCGCGTATTTGAAGGGATGGCACAACGAGGTAAAACGAGTACAGGCTGGTTTTATGGCTTTAAACTTCATTTGGTTATCAATGATTGCGGT
X_nematophila_RAND_541	ATTAGGCCCCTTTCCACTGAAACTCATCGATTAGCGACGCAGACCCAGACGCTCAATCAGCGTGGTGTAGCGAGCCAAATCTTTACGCTTCAAGTAGTTCAGCAGCTTACGACGCTGTGCAACCTTTCTCAGCAAACCACGACGGCTGTGGTGATCTTTTTTATGCTCAGAAAAGTGACCTTGCAGTTGGTTGATATCAGCAGTCAGCAGG
X_nematophila_RAND_542	ACAGGTATTGGCATGTGCACAGCGCTTTGCCGATTATTTATCCGGTCTTGACAAGCATCCG
X_nematophila_RAND_543	GCGTACTCACGATGCCGTTGTTCATTTGCAGCAGTACTATGATCAGCACGGCCCGGCACTGGCTCAGGCGATTAAACTGACTCCGGCGGTTCCTTCTGTGGAAGA
X_nematophila_RAND_544	AACGGCTGTTTTTCAATTCGTCGCTGGTTGGGTTCAATACGTACTG
X_nematophila_RAND_545	ATTATGATGTTCAATAAATGATGATTTTTACTATGACTGATAAGTCGATGACTTAAAATATGACATGAATGTTATATTAATTTGTAATATTTGCATATTTTAATTTGGTTTACATATTGTAAACTA
X_nematophila_RAND_546	AGGAATGGATTTTATGCCACCAGCAGCAAAGAGTACGCACACTGACCCTCAACCGTCCTGAAGTGCGTAACGCCCTCAGTAATGA
X_nematophila_RAND_547	CCCCTTACACAAAGGTGGTGATGATCCTGTCCCACCTAAAAACGAC
X_nematophila_RAND_548	ACGTCATAACACTCATTGAATCTATTATTCTCCGGTTAAATATTATTTAATTTAAATAAGATAATTATCAATATAGATATAGATATAGATATAGATATAGATATATTTTC
X_nematophila_RAND_549	ATCCATTGTCACAATTGGCGCCAAAGGGTATCGCAGAAAAAAGTCCTTAGATATCAGCTGCTGTTCGGAGCACATAATCAATAGGCCATCGACGCGCTTTTGCAACAGGGTTTCCATACAGCGGAG
X_nematophila_RAND_550	GTGCGAGGGCTATCTGGCGCCGCCGCTGCAAGGTTACCGCCTAACGCAATCAGTACTTTGACTTCATCACGCAACATGGCGCCCAAGGCCTCCACGACATGATGACCGTGAGCACGGGGAGGTTCGAATCCAAAA
X_nematophila_RAND_551	TTGGAGTTTAAATTGTCACTAATTGTTATATTTTTTGGTGTGACAAAAATATAAGATAAGGAATGAAAATAG
X_nematophila_RAND_552	TGTCTACACAGTTCACCGCCATGAATACAATTACGCTTGCTGATTT
X_nematophila_RAND_553	AACAGGGTTTGTAAAGTGAACGCGCACAATAAAGAACTGTTTCAAGACTACCTCAGAAAAAGGCATAGTGTGAGCAAACTAGTTGTACATC
X_nematophila_RAND_554	ATCCAAGACCCTTATTTGACGCTGCCCAGAAATTTTTGTGCGAATCCCGCAGAAGCGTACACCATGCCCGCTCGTTTCTATACTTCTCAGGACGTCTTTGATTATGAAAAAGAGGCGATTTTTGCCAAGA
X_nematophila_RAND_555	TGCGCTTTTGTAATCGCGCTGACTAATGCCACGCCACCGACACCTGTTGCAACCACATCCGGTACACGTTCCAGTGAGATGCCGCCAATGGCGACAGTCGGGTATTCCGGTGTGATTTCCAC
X_nematophila_RAND_556	GGCATATCCCGATGCAATTAATCCGCCGCAATATGACAGAAGAGCTGGAGCATTGCCACGAAGCCCCATTCTATACATTAGGGCCGCTAACGACGGATATCGCCCCCGGTTATGACCATTTCACTTCTGGCATTGGTGCTGCCATGATTGGCTG
X_nematophila_RAND_557	TAACATTAGCAGACAAGAGTTAACTTAATTCAAACATGCATGCAAAAAAATGTCAATT
X_nematophila_RAND_558	GTTTAGAACGGGCGAATGTATTATCATTCGTCCGTTTCTACAAGGCTGTAAAAAATCGGAGGATAATATGTATTCTGAATCCCAGTCTTTAATAGAGGCAGTGCT
X_nematophila_RAND_559	GGAACTAGGCAAAATGGTGCCGTAACTT
X_nematophila_RAND_560	TTTGCACAGACCGTCGCAAAACCAGATTGCTCTCTGGAAGATGCCATTGAAAATATTGATATCGGTGGCCCAACAATGGTT
X_nematophila_RAND_561	CAGGCTTGCGCCCATTGTGCAATATTCCCCACTGCTGCCTCCCGTAGGAGTCTGGGCCGTGTCTCAGTCCCAGTGTGGCTGGTCATCCTCTCAGACCA
X_nematophila_RAND_562	CGGTTCATATCACCTTGCCGTCGCTTATCGCAGATTAGCACGCCCTTCATCGCCTCTGACTGCCTAG
X_nematophila_RAND_563	GGATTGTCATCCCCAATATTTCAGCGACTATTGCCAGATCTTCACCGTTATAATGCACTGGAATTTCAATCTTTTTTCCTGCGGCATAACTACGTTCCTGCAAATCACGGTGACAGATTTCTTCAGCCAATTGCTGGGCTGATATTTTTATCG
X_nematophila_RAND_564	AATAATCCTCGCCATATTGAAGCGCAGGTGATTGCGGATAAACAGGGTAATGTTGTCGTACTCGGAACGCGTGATTGCTCCTTGCAACGCCGGAATCAGAAACTGGTAGAAGAAGCGCC
X_nematophila_RAND_565	TAGAATACCTTTGATGCCCTTCTAAGTGTCAAGTTGTTAT
X_nematophila_RAND_566	ACCAACGATGGCGCTGGCTGCTACTGAACCGCCCAGATAACCAAACAAACCTGTAAAACCTGCCGCTGTTCCTGCTGCTTTTTTCGGTGCCAGTTCAAGAGCATGTAAACCAATCAGCATGACTGGGCCGTAAATCAGGAAGCCGATGACCAGCATACAGATCATATCGACAGTTGGGTTACCCGCAGGGTTCATCCAGAAAACCGTGGTAGCT
X_nematophila_RAND_567	ATGTTCACTACAGTCAGAGCATGAATAACCATTTGTAGTAATATCCATTATTTCGGATGCT
X_nematophila_RAND_568	TGGGCAAAAACTCTCTCCTGCTACTGATATGAAAATGAATAGTAATATCAGTCAAATGACAGCAGAACTAGATCCTTGGTTTAAAAATGTCCCCTCTCGCTTGGC
X_nematophila_RAND_569	TCAGTTGGTATCCAGGCTTCATGCAGCACTTCCCTGAGTGCTAATTGTGTCTCGCTCACCCAATCCTCTGCTACAATCATATTCTGATGGAACAGAACAAACGCTTGGATCTTAGCCAAATCACCA
X_nematophila_RAND_570	GAGAAAGTCGTTCAATTCGGTTCTATGCCATGTCAGTCCAGTATCTGCGAACGTCGTAAACAATATTATGAAATATTGGAAAGAACCCAGCGTAATAGCTTAGATATTACGGACTGGATGGTG
X_nematophila_RAND_571	CATTGTGTATACACAATATCATCAGCTACCGTATTTTACTTTTACTATACGGCACCTGCGATACGCG
X_nematophila_RAND_572	TGGATCATCCACGGTATGGATTGCCCGAGTTGTGCAGGAAAAATCGAGAATGCAGTCAAAAAACTCCCGGAAGTGAAACAAGTCAA
X_nematophila_RAND_573	TTAATTATGGCGGTATTAATGAATATGCCCACTGAGATAAATTCTAATGGTGATAAAATCCAGTCTAACATTTTCATCACACCACAACACATAT
X_nematophila_RAND_574	TGGCGATGGGCTTATCTCTATGACTTAAATAAAAAACATGACTCAAATAAAAAACAGCAAATTATATTGATACTTTTGGTTGCATTGGCTGTTATTTGGTCGTTTATTGCTTCGCGCGGCAGTATTGATATCGCTAC
X_nematophila_RAND_575	ATTAATATTCTTGATTTTTTTATTCTAAGATTCAGAAACATCTCATGTATTATATAGTCATTGTAAATAATAACTGACATAAAATGGGTATATCTTT
X_nematophila_RAND_576	AAAATGTTCTCATTAAAACCATTTATTTATATTATATGTAAATGGTAGATATTTTCACTGCATTTATTCAATTCTAGTGGACGAAATATGTTAAC
X_nematophila_RAND_577	CGCCGTGGTCTTTCCATCCAACGTTATAAAGGTCTGGGGGAAATGAACCCAGAGCA
X_nematophila_RAND_578	CCATTTCCGCCGTCATTGAAAATAGTGCGGCAACGACAGCGGTTCGGCTTTGCCACCAAATGCTGTTTAACACCGCACAAATCGTCGAAGTCTTCGTTGTCGGTGTG
X_nematophila_RAND_579	TTCAGGTATTTATTTTGCCGGATTTCAATCCCCTGCTGAGGCTCACCTTCCGCATTGAGGAGGGTGAGCGCGGCGGTATTGGCCCCACTTTTAGCGATAGTCACGACGGC
X_nematophila_RAND_580	TATCGGCAAAAAGTTTGATAAAGCTCGCCAGCCCTGCACGAAATACCGTTGAGGTTGGGAACATAT
X_nematophila_RAND_581	ATCAATTAATTGCTGAGATTCTTCCAGCAATTCAGGCTGGCTGTATTTTTCTGTTGCGAGCGGACTTTCATAATCGAGGGTTTTTGCAGGTGAAATGGTAATA
X_nematophila_RAND_582	AGTCTTCACCACCCAAGTGAGTATCACCGTTGGTTGCCAGAAC
X_nematophila_RAND_583	TCGCCTGCTTCACCTTCACCACCCAAGCGAATACGATCACCGGTATCAACGCCTGCCGGAATTTTAACAGACAGGGTTTTGTATTTTTCAACACGACCGTGTCCATGACATTTACCGCAA
X_nematophila_RAND_584	CCGCATCACTCAATTTAGGTGGGAGCCCTCGGCTTCTGAATCGCACACCTTGTTGTAACTGCGTTAAATTGTCATCTACCCAACAAAACACCCAAATGATAAAATCTTGCTGTGACATAGCCTTTTGTTCCTTTATTTCTCTATTTTTG
X_nematophila_RAND_585	CAAAAAGCCGCCATTTGATGATGTCAGAGTCAGGAAGGCATTAAGTCTGGCTATAGACAGAAAAGTGATCGCTGAAAAAGTATTG
X_nematophila_RAND_586	ATTGAGCACTAAATAGTTAG
X_nematophila_RAND_587	TGAGTTCCGCATCTAACGTATTTAAATACTCGGTTGTGCGGTTGATCTCCGTGGT
X_nematophila_RAND_588	GGAAAAGGCGCTACATTTAGCTTTCTATTGGCCCCTCGACTGATTGTTTCTTTCAAAGAAAGTTTATTTAAAAAATAAT
X_nematophila_RAND_589	TCAAAGAAAGTTTATTTAAAAAATAATAAGTTAAATGGAATTAAATGGTAACAATACGGACAAAAAAATGATTTATTAATTAAT
X_nematophila_RAND_590	TTTTTGCTAACGGCTGTTGGCCTGCCAGTCATTACCGTCATTGCTTTGGCAAAAGTCGGGGGAGGCATTGAATCACTCAGTGCTCCTATTGGTAAAA
X_nematophila_RAND_591	CGGTTGCGCGGCTGGTTTGGAATTATTGGCAATAGATCCAATACTGGAGAGCTATTACAGTTTGTCAGCGTTTT
X_nematophila_RAND_592	TCCAGAAGCTGGCGTTGCTCTGCGCGGTTCTTTCCTGATCGACAAAAATGGTGTTGTT
X_nematophila_RAND_593	AGGTTCAATGCCACAACATACTGTTCGCCCAACGCAGAGACCAGTGCTTCACGGGCACGGAGCTGAACATCAGAACTATTGAAACGAGCAAGGATTGCCCCATTTTCCAACGCAATGGACTTGCTCTTGATTTGATCTTTGTCTAAAACATTAC
X_nematophila_RAND_594	TCGCAGCATAAAGGTGTTCCAGAGAATTATCAAAAACGCAGGGTAACCGGCAAATTTCAACAGACGCACCGGCAATCTGACATCCTTGCAATGGTTTAATGGCTTCCCA
X_nematophila_RAND_595	CACAAATGGGGCGGAGCAAAAGCGATAAGGAGGCAAAAAAGATGTTCAGTTGATGA
X_nematophila_RAND_596	TGCCAAAAAAACCGTTGCTGGCGTTAGCATTGCCTGCCATTGACGGTGAAAAATTGCTGGGATTGATTGGGT
X_nematophila_RAND_597	TCCAATGGCGCCTTTCACCTGAAGTTGGTTCAAGGAGCCATCAACAAGAATATTAACTTTATCCCATTCCCGCAGTGATTGTGTATCCAATACCGGTAATTCACTGCTGATATGCGACAAATCTGCGTCTACTGCAACACGGTATTTCACCTCGTCCTTTGGAGAAACATCGTCTGAAGG
X_nematophila_RAND_598	TGAAGCTGGTAAAAGGACAGGTCACGAAAATACCAGCGCCGCTGTAAAAGCGAGCGCCAAATATCCAGAGAAAGCACTATCTTTTTGGCATGAATATCACCATGTTCTGCTTTCGCGCTGATATCACGAATTTCCAGA
X_nematophila_RAND_599	ACATTCGCCCCCATAGTTTTAATGGGGGCATTTCTCCCGTTGAATACGAGAAGCAATGGGAAGAGGCTAAAAGAATGTCC
X_nematophila_RAND_600	GGAGCATGCAATCAGATCATAATTCTAATTTTATTTGTTA
X_nematophila_RAND_601	GTGAACGTGTTAAGGATGTCACAACGCATCCCGCTTTTCGTAATGCGGCTGCCTCTGTTGGTCAGTTATATGATGCCCTGCACTCTCCCGAAACCCACGATACTCTCTGCTGGAATACGGATACCGGCAATGGTGGTTACACACACAAATTTTTCCGTTTCGCCACCAGCACTGATGATATCCGCCAACAACGTGATGCCATTGCTGAATGGTCACGCCAGAATTACGGCTGGATGGGACGTTCACCCGACTATAAAGCTGCTTTCTGCTGCTCATTAGGCGCTTACCCTGAATATTACGGGCAATTCGCTGATAATGCCCGTCTCTGGTATAAACGTATTCAGGAAAGCTGCATTTACTTTAACCATGCCATTGTTAACCCGCCTATTGATCGCCATC
X_nematophila_RAND_602	GCTGCGGCTCAGGTCTATTTTGGCAAGACAGTGAATGAACTGACGTTGAGTGAGATGGCGATGATCGCCGGATTGCCGAAAGCGCCTTCAACATTTAACCCGCTTTATTCCTATGACCGTGCGATGAGCCGCCGGAATGTGGTATTGGGACGGATGCTG
X_nematophila_RAND_603	TGTTTGTTAATATTGAAGTCTTTTCCCTTTATGGATAAATATGAGCGTGTTAGTCTTTTTAATGTTTATGTTATCTATAATAAATAACGTTAGCGTT
X_nematophila_RAND_604	GCTCAGTCAAATTATAACTCTTTAAAATAGGGCGAAAAAAACCCATAGCGGTTTCCCGCGCCTGAAGTAATGCAATAGTCAAGGATTCATGCATAAGTAAAAGTAACTCTTTAAGTTAATTGTTAGTCATTC
X_nematophila_RAND_605	CAACTGATTAATACATTAATAATGCCTTAAAGCTCTTGTTCGCTTTCTTCATCCATATTTTCCTGAGAATGGTTTCCAATGGCAATAAATTCATCCAATAACACTAAGAGTTG
X_nematophila_RAND_606	ATAGGGAATCTCTAAAAAGTCCCAATACAAAAAATAAGGTCAATTTTGCACTCACTCATCAATAAATTGACCTTATTGTGTATGACTTTTTCTTGCTTTTTTAGCGG
X_nematophila_RAND_607	TTTGTGGTATAGCGTGAAGTGCGTGATTCGGCGTTCAATGCGCTAGTTGACAGTATAAAAACGCCCTTTGGGGGTATTTTTAGTTTAAAAAACCTTCATCTTTAGACAAGGGGTTTATGTCTGACAATATCTGCTTTC
X_nematophila_RAND_608	TCTTTCTTCGGAAGGTTATTCCTATATTCCCAGTCATTATTATAAAAATTTAGATGGAATGAATGAATTTATCGAACTTG
X_nematophila_RAND_609	TGTTCAATATCAGATAATAGTTCGGGTGGATAGGGATAACCGGTATTAGTCACGCCTAGCTGTTCTCTGCATTCAT
X_nematophila_RAND_610	TTATATAATCTGAATAAAAATAGCGGCT
X_nematophila_RAND_611	AAAATTGTGTCCATGAAAATTACCCTGACAGATGCTCAAAAAAACGCGCTCGAATTGATGCCTGATATGACTTGTGATGGACGTGTGCGTGATCGCATTAAGGCCGTGCTTTTGGCATCGGAAGGCTGGACTGCCCAGATGATTGCCTAGGCTTTGCGTAT
X_nematophila_RAND_612	ATGGGTAGCCAGGTCAGTGAAGAACAAATGAATACCATTTTGGGTTACATTGATCTGGCCAAAAAAGAAGGAGCAAGCATACTGACGGGCGGAAACCGCATAACAGGTGCAGGATACGATGATGGTTTCT
X_nematophila_RAND_613	CAGCAGCCCTGGGCAGCGCTGGGATTCAACAAAGTGTTGTTAGATCCCGCCC
X_nematophila_RAND_614	ACAAAGCTGCTCTGTTGCCAGAATAATCCTCGGTCCTGCACGGCTGAACCAGTCATCATTCAGTGCGATGATGTTGACTTTCATTTGTGGTTGCCAGAAATCTGCAACTCGCTGTTTTTGTTCTTCTGTTCCGCCTATCACGATCACTTCTG
X_nematophila_RAND_615	ACAATCGCGACTTCTTTACCATCAATGC
X_nematophila_RAND_616	GTTACAAGGCCAGCATGACAGAAAACAGAATGGTCCTAAGTGACAAATTGTCTTTTGTATCAATGGGATAATTTGTA
X_nematophila_RAND_617	TGATTGTAAAATCACGGCGGGCGGCATCTTCTTCGACTGAACCGAAGATATTATCACGCAGTAAC
X_nematophila_RAND_618	CGGGATTAACGCGTTTATCGTCTCGAATACGATGGTCGGTATTTTTCAGTACCTGAACCAACAATTTCTCCATTGGTGAATCACCGGTTTGGGTTAAACCGCGTT
X_nematophila_RAND_619	CGCAACATTAATCTTCCAGCAGGGTAACGTGCCCAATATAAGGCAAATGGCGGTAATGCTGTGCATAATCAATACCGTAACCGATGACAAACTTATCTTCAATCGAATAGCCAATCCATTCAACGGGAACATCGACTTCACGGCGAGAGGGTTTATTCAGCAAAGTACAGATTGCCAGCGAA
X_nematophila_RAND_620	CATACTCATCGTCCGGCCATTCATGCTATTGAGGTTGATGGTAAAACTGTACATCGCGGTGTACTGGGTGCATGGCATGAACAAGGTTCAATGTTTAAAGTGACAGAAACATCCATTGAGTTGATCTCTTTTCATTTCTGAGCTCGCTTAAATTTTTAAAAAATCGGTAATTCAAA
X_nematophila_RAND_621	TGGAGGTATTAATTTATTTTTAATTTGAGGATGAATTTTC
X_nematophila_RAND_622	AATCGGCCATTGAATGGGCTGATGCAAAGCACCCCAATAGTACAACCGTGCGCCGTGA
X_nematophila_RAND_623	CTAAATGAATTTTGGTAGAAAGTCCTCCCCGACTTTTACCAATGGCTTCATCTTCCACAGAAGCGGCACCTGAACTATGTTGATGAGCCCGAACAATACTGCCATCAATGAATAACCATTCTGTATCTGTATTCTCAGATAATAATTTGAATAATAAATTAAAAATAGCTTTCTTAGACCAATCATTAAAGCGCTTAAAAATGGTGTTCCATTT
X_nematophila_RAND_624	GTTAGTTATCCTTTGAATGACTATGACAGGCGGTACTTGTACCGCCTGGCTTTTTTGTGGACCATTCCATGAAATGTTGCATATGATTATCATTCATGCCATATACTATGGCTGTCAGATATTTGAGTGGAGCATTGAGGATGAGTAGTAAGAAGTATGGTGTCCTATTGGTAAATCTTGGTACACCAGATGCACCAACACCAACAGAAGTAAGGCGTTATCTGGCAAAGTTTCTAAGTGACAGAAGGGTCGTTGATATCCCATCATTAATTTGGAAGCCTATCTTGTACGGTTTTATCCTTCCTTTCCGTTCTCCCCGTGTTGCCAGGCTTTACCAAGAAATCTGGACGGGCGAAGGCTCTCCTCTGTTGGTTTATAGTCGTCGGCAGCGAAAGCTACTGGATGAAAAATTAGCAGATATTCCCGTTGTGTTAGGCATGACTTATGGTTCACCTTCCTTGTCTCAGGCGATTGATAATCTGCTGCTGCAAGATATTGATGAGCTGATTATATTGCCACTTTATCCTCAATATTCCAGTACAACCTCAGCGGTCGTATTTGATAGTGTCAGTAAAATATTGCGGGGATATC
X_nematophila_RAND_625	CAGTATGGTGTGACAGCCAGTCGAATTGCTCATGGTGTTCCCGTGGGTGGTGAGCTTGAAATGGTGGATGGTACTACCTTGTCTCATTCGTTGCTTGGTCGTCAAAAAAT
X_nematophila_RAND_626	TTATCTTCTGCGTCAATGCTGCTTTTATGGATTTCCAGCGTATCAGTGCCATATTCCAGATCGTAAGTTTCGCTCAATGTTTCACGCGGTAATTTACCTTTTTTGCGGACAGGTACGAAACCAACGCCCAGACGCAGTGCGACAGGCGC
X_nematophila_RAND_627	AGGCGGCAACTTGCGTTACAGTTGCTTTTTTTCGGTAGTTTGAATAAATTTTACCGTTTTC
X_nematophila_RAND_628	GGTAACTGTGAAGCCAGCTGTTCCATTAACACCATTGCATCACCGG
X_nematophila_RAND_629	GGTCTATTTTGTCTAGCATATCTCAATCCTGTAGAAATATTTCCCAAATATA
X_nematophila_RAND_630	GATAACGGTGAGTATTTTTATGCGCAGGTTGAATATCTTGAATCCCCTGAAATTGATGAGCGTGAACAAGAAGTACTGGTAAGAACGGCCATTAATCAGTTTGAAGGCTATGTCAAACTGAATAAAAAGATCCCGCCGGAAGT
X_nematophila_RAND_631	AATGTGTCGATTTATGTAATGATATCATTCGCGAAGAAAT
X_nematophila_RAND_632	TTGCAGATGCGCTACCAGCAAGTTTGCCGGAACTTCACGACCATGCCATTCCTCTGTTTGGCAGGGTAAGATAGTTG
X_nematophila_RAND_633	ACAAGGTTGGCAATCCGTTCCTTTGTTTGTCACAGCCGCCGTCACCGGAGAAGGTATTGCACCACTCAGAGAATATTTACGTTCTATTCATCAATCACAGCTGACTCACCAGC
X_nematophila_RAND_634	CGCCTTTATGCCGCTGTACGCACTGGGCTTCATGGGTATGACTCGTCGTCTGAGTCAGGATATCAATCCAGAATTCCATCCAATGCTGGTTGTTGCAGCGGGCGGTGTTGTCTTAATTG
X_nematophila_RAND_635	ATTATCACCGTCAGCGTATTCAGCAATTTGCGGATGTGATCCGTCAATATGATCAGGATAAAGGCGGCATAACCGCAGTCGGTTTCCGCGATGAATTC
X_nematophila_RAND_636	AACAAACATAATGACCATTGGATTTTAATGGTTATTGGTATCTTTCCTGAAAACAGCAATCAAAAATTAAATAATAAATATTAAG
X_nematophila_RAND_637	GATCTACTGAAAATGGAGAAACTGTTCTTTATTGGTGTCGCTCTGATGTCAACGGGATTTATTCTTACCTTCCAGCAAAATACAGTATTCTGGCTATTGCTGTTTGCAATCTGGGC
X_nematophila_RAND_638	GGCTCCGTCAATACCGCCTTGTCGCTGAGCATGAACGCACAGTACGCGGCAGCTAATGGCCGTGGCGGATTGGGTACTATCATTGTGGCAGCGGGCGGCAACAATC
X_nematophila_RAND_639	GAAAAACTGAGGGGCTGTGGTTACCTTTTATAATGGTATAGCTATATACATATAT
X_nematophila_RAND_640	GAAAGTTCAGGAAGAAAAAGAACACTTGCGTTTACCTGCATTGTTTTGCTTTCCCCAGATTTTGCAACATCGTCTGCG
X_nematophila_RAND_641	CACAAAGAATTTGTCATTGGCACCTAATCCCATGTGAAACAACAAATGCGCTTCCCCTTTTGCCCACAATGCTG
X_nematophila_RAND_642	GGAAATAGAGTTTGTCATCAGTTATAACCAATTGGAACAATCGGATTTCAATAATTATCCGTTGTTTAATGATGAGTTAGTTCTGGCCGTTTCTAAACATCATCCGAGA
X_nematophila_RAND_643	GGGCTTTTTCATCATATTACTGAGGGGTTAATGTGAAACTGGATGAGATCGCCCGCTTAGCAGGTGTTTCACGGACTACGGCCAGTTATGTTATCAATG
X_nematophila_RAND_644	GTTTTGCAGCCCGGTATTGTGGCAACCCTTCCGGATAACGAACCATATGGTCTTCAGTAACATTCAGCACGGTGGCTGCT
X_nematophila_RAND_645	ATTGCAATCAGGACAGGCAATTGTGACTGGGCTGAAAGAAGCAGGCATTAATGCTT
X_nematophila_RAND_646	GGGCTCTTCCCGACAGTCGCCTC
X_nematophila_RAND_647	TGTTAAAAAATCGACAATACTGCGGTTTGCAGGCGGGAATTC
X_nematophila_RAND_648	GCCTATTTTATGCGCCCCGAACGATCCAGATGATGCACGCCTGTTATCAGAAGTTGCGAACAGTAAAATTGACGAAGTATTTATCGGCTCTTGTATGACCAATATTGGTCACTTCCGCGCGGCGGGTA
X_nematophila_RAND_649	AAACGGGAGATACCGTCAAGATCCGCCAATCACACGGTGGCTCAGGTAAACAGGCAACATCTGTTATCAATGGCCTTCAGGCTGATGTTGTCA
X_nematophila_RAND_650	CGGTATTTCTTACACAGCATCCTGAAAGTCCCTGGACATATTCTTCTTACGCATAAGCAGAAATTTTAAATTATTTCAGTGTAATAACACTT
X_nematophila_RAND_651	TTACGTGTCGCAGGCGGGGCAGAAAAAATAATAGCTGCACTGGCCGGTGCCATTTTCGACAATAATGCCTGACGACGGGATAAATATTCTTGTTTAGTCATACCCTCTCCTGCGATTTAATTATTATTTAGTTGATTATCGCCAAGTTAGTGCAACGTTGGCTTTTCA
X_nematophila_RAND_652	GTATCCTGTCACGATCGACACCATAATGCCCCACGTCATGTACGTC
X_nematophila_RAND_653	ATACACAATTTCCAAATTTTGAAATAGCAATATTATTTTGTGATG
